30 100
AAATAACGTTAGAACACCCCGTTTCGTAGT|ACCCCGTTTCGTAGTGTTAGCCGGGGCAAC
ATACCCCGTTTCGTAGTGTTAGCCGGGGCA|GCAAAATTCCGGCCTTGCCTGTACTAGGTG
GGCAACCGGGGCAACGTAGTGTTAGCCGGG|TGTTGCGAGCTCCGTCAACGCTAGATCGTT
GCTTAGCCATCACTGCAAACCGTCTGGGCT|ATAGTGGTCTACACCCCAAACCCCGTTTCG
TTAGACGCCTACTGGCAATCTGCTCAACAA|ATAACGTTAGAACACCCCGTTTCGTAGTGT
TGACAGCAGGCTACGATTGCACTGACCACC|CAACCCCGTTTCACCCCGTTTCGTAGTGTT
GTGGCCTCTCCTCAAAGGCGCATATGATCG|TGCCACGATGAGCTTGGGCGCTGAACTTAG
TGTTATTTACATGACGCACTGCTCGAGCGG|CATTTTAGACGCCTACTGGCAATCTGCTCA
TCGTTACCACACGCATTATAAACTTTCCCT|GTTTCGTAGTGTTAGCCGGGGCAACCGGGG
ATAGTGGGTAAATAGACGATAGTGGCCTCT|ACGCATTATAAACTTTCCCTGTGCCACGAT
CGTTTCGTAGTGTTAACCCCGTTTCGTAGT|TTGTTGGCCTATAGTTAAGTGTACCTAGTA
TTTCGTAGTGTTAGCCGGGGCAACGCCGGG|TACCTAGTATAAGCGCCGAGATCCCCGAAA
GTTAGCCGGGGCAACCGGGGCAACGTAGTG|GGCTTGCTCTGTTGCGAGCTCCGTCAACGC
GGGGCAACGTAGTGTTAGCCGGGGCAACCG|AGCTCCGTCAACGCTAGATCGTTCGCAGTT
ACCCCGTTTCGTAGTGTTAGCCGGGGCAAC|AGCTGCGGGAAATGACCACCCCGTTTCGTA
TAGATCCGGAGTCTGCCTCGTGTAAACTCA|CGTAGTGTTAGCCGGGGCAACAGGCCTCGG
GATATCCGAGATTCACCCCGTTTCGTAGTG|CTTAGGTCTTTAGGCTCGTCAAGCCCGTTG
GAGATTCACCCCGTTTCGTAGTGTTAGCCG|CTTTAGGCTCGTCAAGCCCGTTGCTCTATA
ATATCCGAGATTCACCCCGTTTCGTAGTGT|TTAGGTCTTTAGGCTCGTCAAGCCCGTTGC
GAGGTCAGTGACTGTGTTAGGATAGAAGGG|AAGACACGAATCTCCATACCCCGTTTCGTA
GCAACAGGCCTCGGGTTACACCAATATAGT|GGGCAACACTAAGGCCGCGAGGTCAGTGAC
CCTTGCCTGTACTAGGTGCGACCCCGTTTC|AATAAACCCATCCGTTAGTCTAGAGCTCGA
TACTGTCACTGTTCGGGCTATCCTTGGCTT|GTTTCGTAGTGTTAGCCGGGGCAACGCCGG
CAGTCGTTACCACACGCATTATAAACTTTC|CCCGTTTCGTAGTGTTAGCCGGGGCAACCG
TGCCTCGTGTAAACTCATTTACAGTTAGGC|GGGGCAACAGGCCTCGGGTTACACCAATAT
GGGTAAATAGACGATAGTGGCCTCTCCTCA|TTATAAACTTTCCCTGTGCCACGATGAGCT
AGGTCAGTGACTGTGTTAGGATAGAAGGGC|AGACACGAATCTCCATACCCCGTTTCGTAG
CAACCCCGTTTCACCCCGTTTCGTAGTGTT|TGTTAGCCGGGGCAACACGGATCTACTGTC
TAGTGTTAGCCGGGGCAACGACCTTTCACT|AAGGTGTAGGTTAATGAGATATCCGAGATT
CGGGCTATCCTTGGCTTGCTCTGTTGCGAG|AGCCGGGGCAACGCCGGGGCAACCACTAGA
GCAACTCGCTCTCTTAGGTCTTTAGGCTCG|GTGCGACCCCGTTTCGTAGTGTTAGCCGGG
TGACCATAGTGGGTAAATAGACGATAGTGG|ACCACACGCATTATAAACTTTCCCTGTGCC
GTAGTGTTAGCCGGGGCAACACCCGCAATG|CTATGCTATGGCCAGACGCCTGATAGGTTC
GGGGCAACACGGATCTACTGTCACTGTTCG|CGTAGTGTTAACCCCGTTTCGTAGTGTTAG
CCGTCAACGCTAGATCGTTCGCAGTTCGTT|CGGAGTCTGCCTCGTGTAAACTCATTTACA
TCGGGCTATCCTTGGCTTGCTCTGTTGCGA|TAGCCGGGGCAACGCCGGGGCAACCACTAG
AGTGTTAGCCGGGGCAACTCGCTCTCTTAG|TTGCCTGTACTAGGTGCGACCCCGTTTCGT
TGTTGGCCTATAGTTAAGTGTACCTAGTAT|AGTGTTAGCCGGGGCAACGACCTTTCACTC
GCCCGAATCTACTAGAAAGTTCTTGAGGGC|TTCGTAGTGTTAGCCGGGGCAACAGATGTG
GATCGTTCGCAGTTCGTTAACACCCCGTTT|CGTGTAAACTCATTTACAGTTAGGCTTAGC
GTGTTAGCCGGGGCAACCCCGTTTCGTAGT|ACTGCAAACCGTCTGGGCTTTGTTGGCCTA
TAGCCGGGGCAACCGCTATCCCAAATAACG|AGATCGTTCGCAGTTCGTTAACACCCCGTT
CAGATGTGCTCGGAGCATTAGGAGCAAAAT|AGTGTTAGCCGGGGCAACGGCGTGCATCCT
CATTATAAACTTTCCCTGTGCCACGATGAG|AGCCGGGGCAACCGGGGCAACGTAGTGTTA
ACCCGCAATGTAAGCGAGCTGCGGGAAATG|TGATAGGTTCGTATAGGTCCTGCAACATAT
CCCGAATCTACTAGAAAGTTCTTGAGGGCA|TCGTAGTGTTAGCCGGGGCAACAGATGTGC
CCAAATAACGTTAGAACACCCCGTTTCGTA|ACACCCCGTTTCGTAGTGTTAGCCGGGGCA
TACGTAGCTAAGGCAACCCCGTTTCGTAGT|TTTCGTAGTGTTAGCCGGGGCAACGTGCCC
CAACGTAGTGTTAGCCGGGGCAACCGCTAT|CCGTCAACGCTAGATCGTTCGCAGTTCGTT
TAGACGATAGTGGCCTCTCCTCAAAGGCGC|CTTTCCCTGTGCCACGATGAGCTTGGGCGC
GACCCCGTTTCGTAGTGTTAGCCGGGGCAA|CTAGAGCTCGACTATGCTATGGCCAGACGC
CAAGCCCGTTGCTCTATATTACCCCGTTTC|CAACACCCGCAATGTAAGCGAGCTGCGGGA
GCCGAGATCCCCGAAACCCCGTTTCGTAGT|CTTACGTAGCTAAGGCAACCCCGTTTCGTA
GTTAGCCGGGGCAACACTAAGGCCGCGAGG|GAATCTACTAGAAAGTTCTTGAGGGCAAGA
GAGCGGGTGACAGCAGGCTACGATTGCACT|TGCTCAACAACCCCGTTTCACCCCGTTTCG
AGTGTTAGCCGGGGCAACCGCTATCCCAAA|ACGCTAGATCGTTCGCAGTTCGTTAACACC
CTCTCCACTTACGTAGCTAAGGCAACCCCG|TTCACCCCGTTTCGTAGTGTTAGCCGGGGC
GCACTGACCACCGTCGTCAGTCGTTACCAC|TTTCGTAGTGTTAGCACCCCGTTTCGTAGT
GAACACCCCGTTTCGTAGTGTTAGCCGGGG|TAGTGTTAGCCGGGGCAACCCCGTTTCGTA
CCGTTTCGTAGTGTTAGCCGGGGCAACAGA|TGCGGGAAATGACCACCCCGTTTCGTAGTG
TTATTTACATGACGCACTGCTCGAGCGGGT|TTTTAGACGCCTACTGGCAATCTGCTCAAC
CGTAGTGTTAACCCCGTTTCGTAGTGTTAG|GGCCTATAGTTAAGTGTACCTAGTATAAGC
TTAGCCGGGGCAACGACCTTTCACTCTCCA|GTAGGTTAATGAGATATCCGAGATTCACCC
CTTGCCTGTACTAGGTGCGACCCCGTTTCG|ATAAACCCATCCGTTAGTCTAGAGCTCGAC
CGTTTCGTAGTGTTAGCCGGGGCAACAGAT|GCGGGAAATGACCACCCCGTTTCGTAGTGT
CGGGAAATGACCACCCCGTTTCGTAGTGTT|GCAACATATAAGCAAAGACCCCCGAAACTC
AGCCATCACTGCAAACCGTCTGGGCTTTGT|TGGTCTACACCCCAAACCCCGTTTCGTAGT
GCTCTATATTACCCCGTTTCGTAGTGTTAG|AATGTAAGCGAGCTGCGGGAAATGACCACC
TTCGTAGTGTTAGCCGGGGCAACCGGGGCA|CTATCCTTGGCTTGCTCTGTTGCGAGCTCC
CATTAAGAAAATGACCATAGTGGGTAAATA|CGTCAGTCGTTACCACACGCATTATAAACT
AGCCGGGGCAACGCCGGGGCAACCACTAGA|GCGCCGAGATCCCCGAAACCCCGTTTCGTA
GACCTTTCACTCTCCACTTACGTAGCTAAG|TATCCGAGATTCACCCCGTTTCGTAGTGTT
ATGATCGTGTTATTTACATGACGCACTGCT|AACTTAGCATTTTAGACGCCTACTGGCAAT
TCGTAGTGTTAGCCGGGGCAACACTAAGGC|CGTGCCCGAATCTACTAGAAAGTTCTTGAG
CTGTTGCGAGCTCCGTCAACGCTAGATCGT|AACCACTAGATCCGGAGTCTGCCTCGTGTA
AAGACACGAATCTCCATACCCCGTTTCGTA|CTCGGAGCATTAGGAGCAAAATTCCGGCCT
TCAGTGACTGTGTTAGGATAGAAGGGCCCG|CACGAATCTCCATACCCCGTTTCGTAGTGT
AGCCGGGGCAACACTAAGGCCGCGAGGTCA|TCTACTAGAAAGTTCTTGAGGGCAAGACAC
GTAGTGTTAGCCGGGGCAACGGCGTGCATC|CGAAACTCCTCTGGAGAGCCCCGACGCGAG
ACTGACCACCGTCGTCAGTCGTTACCACAC|TCGTAGTGTTAGCACCCCGTTTCGTAGTGT
TGTTAGCCGGGGCAACGCCGGGGCAACCAC|ATAAGCGCCGAGATCCCCGAAACCCCGTTT
ACTTTCCCTGTGCCACGATGAGCTTGGGCG|CAACCGGGGCAACGTAGTGTTAGCCGGGGC
TTCGTTAACACCCCGTTTCGTAGTGTTAGC|TTTACAGTTAGGCTTAGCCATCACTGCAAA
CAAAGGCGCATATGATCGTGTTATTTACAT|CTTGGGCGCTGAACTTAGCATTTTAGACGC
GGGCAACGACCTTTCACTCTCCACTTACGT|AATGAGATATCCGAGATTCACCCCGTTTCG
TTCACTCTCCACTTACGTAGCTAAGGCAAC|GAGATTCACCCCGTTTCGTAGTGTTAGCCG
GAAAATGACCATAGTGGGTAAATAGACGAT|TCGTTACCACACGCATTATAAACTTTCCCT
TTTTAGACGCCTACTGGCAATCTGCTCAAC|AAATAACGTTAGAACACCCCGTTTCGTAGT
TAGTGTTAGCCGGGGCAACACTAAGGCCGC|GCCCGAATCTACTAGAAAGTTCTTGAGGGC
AGTTAAGTGTACCTAGTATAAGCGCCGAGA|GGGCAACGACCTTTCACTCTCCACTTACGT
CAACGCCGGGGCAACCACTAGATCCGGAGT|ATCCCCGAAACCCCGTTTCGTAGTGTTAGC
CTCTCCTCAAAGGCGCATATGATCGTGTTA|CGATGAGCTTGGGCGCTGAACTTAGCATTT
CCGTTTCGTAGTGTTAGCCGGGGCAACGTG|GTCAAGCCCGTTGCTCTATATTACCCCGTT
AGTCGTTACCACACGCATTATAAACTTTCC|CCGTTTCGTAGTGTTAGCCGGGGCAACCGG
TTAGCCGGGGCAACACCCGCAATGTAAGCG|TATGGCCAGACGCCTGATAGGTTCGTATAG
GGGCAACAGGCCTCGGGTTACACCAATATA|CGGGGCAACACTAAGGCCGCGAGGTCAGTG
ACTGTCACTGTTCGGGCTATCCTTGGCTTG|TTTCGTAGTGTTAGCCGGGGCAACGCCGGG
TTAGCCGGGGCAACGTGCCCGAATCTACTA|CTCTATATTACCCCGTTTCGTAGTGTTAGC
GCCGCGAGGTCAGTGACTGTGTTAGGATAG|AGGGCAAGACACGAATCTCCATACCCCGTT
CCCGTTTCGTAGTGTTAGCCGGGGCAACCC|GCTTAGCCATCACTGCAAACCGTCTGGGCT
TTGCTCTATATTACCCCGTTTCGTAGTGTT|GCAATGTAAGCGAGCTGCGGGAAATGACCA
GTCTGCCTCGTGTAAACTCATTTACAGTTA|GCCGGGGCAACAGGCCTCGGGTTACACCAA
GTTAGGATAGAAGGGCCCGCGAAAGGTGTA|ATACCCCGTTTCGTAGTGTTAGCCGGGGCA
CGGGGCAACGTGCCCGAATCTACTAGAAAG|TATTACCCCGTTTCGTAGTGTTAGCCGGGG
TACCTAGTATAAGCGCCGAGATCCCCGAAA|CCTTTCACTCTCCACTTACGTAGCTAAGGC
ACCCCGTTTCGTAGTGTTAGCCGGGGCAAC|CTCGTCAAGCCCGTTGCTCTATATTACCCC
CGTAGTGTTAGCCGGGGCAACGACCTTTCA|GAAAGGTGTAGGTTAATGAGATATCCGAGA
CAAATAACGTTAGAACACCCCGTTTCGTAG|CACCCCGTTTCGTAGTGTTAGCCGGGGCAA
CGCTATCCCAAATAACGTTAGAACACCCCG|TTCGTTAACACCCCGTTTCGTAGTGTTAGC
TTCGTAGTGTTAGCCGGGGCAACGCCGGGG|ACCTAGTATAAGCGCCGAGATCCCCGAAAC
GCAACCCCGTTTCGTAGTGTTAGCCGGGGC|AGCCGGGGCAACGTGCCCGAATCTACTAGA
GATGAGCTTGGGCGCTGAACTTAGCATTTT|GTGTTAGCCGGGGCAACCGCTATCCCAAAT
CTATCCCAAATAACGTTAGAACACCCCGTT|CGTTAACACCCCGTTTCGTAGTGTTAGCCG
CACACGCATTATAAACTTTCCCTGTGCCAC|AGTGTTAGCCGGGGCAACCGGGGCAACGTA
GCTCTCTTAGGTCTTTAGGCTCGTCAAGCC|CCCGTTTCGTAGTGTTAGCCGGGGCAACAC
AAGCGAGCTGCGGGAAATGACCACCCCGTT|TATAGGTCCTGCAACATATAAGCAAAGACC
CACCCCGTTTCGTAGTGTTAGCCGGGGCAA|TAGGCTTAGCCATCACTGCAAACCGTCTGG
TATAGTTAAGTGTACCTAGTATAAGCGCCG|CCGGGGCAACGACCTTTCACTCTCCACTTA
ACGATTGCACTGACCACCGTCGTCAGTCGT|ACCCCGTTTCGTAGTGTTAGCACCCCGTTT
TTAGGATAGAAGGGCCCGCGAAAGGTGTAG|TACCCCGTTTCGTAGTGTTAGCCGGGGCAA
CCCGAAACCCCGTTTCGTAGTGTTAGCCGG|CTAAGGCAACCCCGTTTCGTAGTGTTAGCC
GGGCGCTGAACTTAGCATTTTAGACGCCTA|GGGGCAACCGCTATCCCAAATAACGTTAGA
TGTAAGCGAGCTGCGGGAAATGACCACCCC|TCGTATAGGTCCTGCAACATATAAGCAAAG
GCCTCTCCTCAAAGGCGCATATGATCGTGT|CACGATGAGCTTGGGCGCTGAACTTAGCAT
GTTAGCACCCCGTTTCGTAGTGTTAGCCGG|GTCACTGTTCGGGCTATCCTTGGCTTGCTC
GTGTTAGCCGGGGCAACCGGGGCAACGTAG|TTGGCTTGCTCTGTTGCGAGCTCCGTCAAC
TCAATCAAGGTAGATATGGTCGGTCTCTGA|TGCTCGAGCGGGTGACAGCAGGCTACGATT
CACTGCAAACCGTCTGGGCTTTGTTGGCCT|ACACCCCAAACCCCGTTTCGTAGTGTTAGC
AGTGTTAGCCGGGGCAACCGGGGCAACGTA|CTTGGCTTGCTCTGTTGCGAGCTCCGTCAA
CGCACTGCTCGAGCGGGTGACAGCAGGCTA|ACTGGCAATCTGCTCAACAACCCCGTTTCA
ACAGTTAGGCTTAGCCATCACTGCAAACCG|ACACCAATATAGTGGTCTACACCCCAAACC
TGCTCGGAGCATTAGGAGCAAAATTCCGGC|AGCCGGGGCAACGGCGTGCATCCTCGGATA
AACTTAGCATTTTAGACGCCTACTGGCAAT|CGCTATCCCAAATAACGTTAGAACACCCCG
CGTTTCACCCCGTTTCGTAGTGTTAGCACC|CCGGGGCAACACGGATCTACTGTCACTGTT
TAGCCGGGGCAACGACCTTTCACTCTCCAC|TAGGTTAATGAGATATCCGAGATTCACCCC
ACACTAAGGCCGCGAGGTCAGTGACTGTGT|AGTTCTTGAGGGCAAGACACGAATCTCCAT
AGTGGGTAAATAGACGATAGTGGCCTCTCC|GCATTATAAACTTTCCCTGTGCCACGATGA
TCGTAGTGTTAGCCGGGGCAACGGCGTGCA|CCCGAAACTCCTCTGGAGAGCCCCGACGCG
GCTGCGGGAAATGACCACCCCGTTTCGTAG|TCCTGCAACATATAAGCAAAGACCCCCGAA
CTCTCTTAGGTCTTTAGGCTCGTCAAGCCC|CCGTTTCGTAGTGTTAGCCGGGGCAACACC
CCCCGTTTCGTAGTGTTAGCCGGGGCAACA|GGGGCAACGTGCCCGAATCTACTAGAAAGT
GCCCGTTGCTCTATATTACCCCGTTTCGTA|CACCCGCAATGTAAGCGAGCTGCGGGAAAT
GGCTTGCTCTGTTGCGAGCTCCGTCAACGC|GCCGGGGCAACCACTAGATCCGGAGTCTGC
TTCGTAGTGTTAGCCGGGGCAACAGGCCTC|GTTTCGTAGTGTTAGCCGGGGCAACACTAA
AACACGGATCTACTGTCACTGTTCGGGCTA|TGTTAACCCCGTTTCGTAGTGTTAGCCGGG
AACACTAAGGCCGCGAGGTCAGTGACTGTG|AAGTTCTTGAGGGCAAGACACGAATCTCCA
GGGCCCGCGAAAGGTGTAGGTTAATGAGAT|GTAGTGTTAGCCGGGGCAACTCGCTCTCTT
GGTCTTTAGGCTCGTCAAGCCCGTTGCTCT|TAGTGTTAGCCGGGGCAACACCCGCAATGT
TTGCGAGCTCCGTCAACGCTAGATCGTTCG|CACTAGATCCGGAGTCTGCCTCGTGTAAAC
ACCGTCTGGGCTTTGTTGGCCTATAGTTAA|AACCCCGTTTCGTAGTGTTAGCCGGGGCAA
TTTAGGCTCGTCAAGCCCGTTGCTCTATAT|GTTAGCCGGGGCAACACCCGCAATGTAAGC
CGGATCTACTGTCACTGTTCGGGCTATCCT|AACCCCGTTTCGTAGTGTTAGCCGGGGCAA
ATATGATCGTGTTATTTACATGACGCACTG|TGAACTTAGCATTTTAGACGCCTACTGGCA
AGGATAGAAGGGCCCGCGAAAGGTGTAGGT|CCCCGTTTCGTAGTGTTAGCCGGGGCAACT
CCACCGTCGTCAGTCGTTACCACACGCATT|GTGTTAGCACCCCGTTTCGTAGTGTTAGCC
ATGACCATAGTGGGTAAATAGACGATAGTG|TACCACACGCATTATAAACTTTCCCTGTGC
CGTAGCTAAGGCAACCCCGTTTCGTAGTGT|TCGTAGTGTTAGCCGGGGCAACGTGCCCGA
TGAGATATCCGAGATTCACCCCGTTTCGTA|TCTCTTAGGTCTTTAGGCTCGTCAAGCCCG
AGCATTAGGAGCAAAATTCCGGCCTTGCCT|GCAACGGCGTGCATCCTCGGATAATAAACC
CCTGTACTAGGTGCGACCCCGTTTCGTAGT|ACCCATCCGTTAGTCTAGAGCTCGACTATG
ACACGAATCTCCATACCCCGTTTCGTAGTG|GGAGCATTAGGAGCAAAATTCCGGCCTTGC
TAGACGCCTACTGGCAATCTGCTCAACAAC|TAACGTTAGAACACCCCGTTTCGTAGTGTT
GTGTTAGCCGGGGCAACGCCGGGGCAACCA|TATAAGCGCCGAGATCCCCGAAACCCCGTT
CTGTACTAGGTGCGACCCCGTTTCGTAGTG|CCCATCCGTTAGTCTAGAGCTCGACTATGC
ACATTAAGAAAATGACCATAGTGGGTAAAT|TCGTCAGTCGTTACCACACGCATTATAAAC
GAATCTACTAGAAAGTTCTTGAGGGCAAGA|TAGTGTTAGCCGGGGCAACAGATGTGCTCG
GAAGGGCCCGCGAAAGGTGTAGGTTAATGA|TTCGTAGTGTTAGCCGGGGCAACTCGCTCT
CCGTTTCGTAGTGTTAGCCGGGGCAACGAC|GCCCGCGAAAGGTGTAGGTTAATGAGATAT
AACCCCGTTTCACCCCGTTTCGTAGTGTTA|GTTAGCCGGGGCAACACGGATCTACTGTCA
AGCTTGGGCGCTGAACTTAGCATTTTAGAC|TAGCCGGGGCAACCGCTATCCCAAATAACG
AAATGACCACCCCGTTTCGTAGTGTTAGCC|CATATAAGCAAAGACCCCCGAAACTCCTCT
AATCAAGGTAGATATGGTCGGTCTCTGAAA|CTCGAGCGGGTGACAGCAGGCTACGATTGC
CCGTTTCGTAGTGTTAGCCGGGGCAACACC|AGCTCGACTATGCTATGGCCAGACGCCTGA
CGGTCTCTGAAACAATATGTTATACATTAA|GGCTACGATTGCACTGACCACCGTCGTCAG
AGCAGGCTACGATTGCACTGACCACCGTCG|CCCGTTTCACCCCGTTTCGTAGTGTTAGCA
ATCCGAGATTCACCCCGTTTCGTAGTGTTA|AGGTCTTTAGGCTCGTCAAGCCCGTTGCTC
CTATAGTTAAGTGTACCTAGTATAAGCGCC|GCCGGGGCAACGACCTTTCACTCTCCACTT
ACGAATCTCCATACCCCGTTTCGTAGTGTT|AGCATTAGGAGCAAAATTCCGGCCTTGCCT
ACATGACGCACTGCTCGAGCGGGTGACAGC|ACGCCTACTGGCAATCTGCTCAACAACCCC
GATAGAAGGGCCCGCGAAAGGTGTAGGTTA|CCGTTTCGTAGTGTTAGCCGGGGCAACTCG
AGCTAAGGCAACCCCGTTTCGTAGTGTTAG|TAGTGTTAGCCGGGGCAACGTGCCCGAATC
AACGTAGTGTTAGCCGGGGCAACCGCTATC|CGTCAACGCTAGATCGTTCGCAGTTCGTTA
TTAAGAAAATGACCATAGTGGGTAAATAGA|TCAGTCGTTACCACACGCATTATAAACTTT
CACCAATATAGTGGTCTACACCCCAAACCC|GAGGTCAGTGACTGTGTTAGGATAGAAGGG
TCTTTAGGCTCGTCAAGCCCGTTGCTCTAT|GTGTTAGCCGGGGCAACACCCGCAATGTAA
CCGGGGCAACCGGGGCAACGTAGTGTTAGC|GCTCTGTTGCGAGCTCCGTCAACGCTAGAT
GTTTCGTAGTGTTAGCCGGGGCAACAGGCC|CCGTTTCGTAGTGTTAGCCGGGGCAACACT
GTTAGCCGGGGCAACGGCGTGCATCCTCGG|CTCCTCTGGAGAGCCCCGACGCGAGCTTGG
TGACCACCCCGTTTCGTAGTGTTAGCCGGG|ATAAGCAAAGACCCCCGAAACTCCTCTGGA
ACAGATGTGCTCGGAGCATTAGGAGCAAAA|TAGTGTTAGCCGGGGCAACGGCGTGCATCC
CGAATCTCCATACCCCGTTTCGTAGTGTTA|GCATTAGGAGCAAAATTCCGGCCTTGCCTG
GTTGCGAGCTCCGTCAACGCTAGATCGTTC|CCACTAGATCCGGAGTCTGCCTCGTGTAAA
TTTCACCCCGTTTCGTAGTGTTAGCACCCC|GGGGCAACACGGATCTACTGTCACTGTTCG
AACCCCGTTTCGTAGTGTTAGCCGGGGCAA|CCGGGGCAACGTGCCCGAATCTACTAGAAA
GTGCTCGGAGCATTAGGAGCAAAATTCCGG|TAGCCGGGGCAACGGCGTGCATCCTCGGAT
TATATTACCCCGTTTCGTAGTGTTAGCCGG|TAAGCGAGCTGCGGGAAATGACCACCCCGT
GCATTATAAACTTTCCCTGTGCCACGATGA|TAGCCGGGGCAACCGGGGCAACGTAGTGTT
AAAGTTCTTGAGGGCAAGACACGAATCTCC|GGGGCAACAGATGTGCTCGGAGCATTAGGA
TCGTAGTGTTAGCCGGGGCAACGACCTTTC|CGAAAGGTGTAGGTTAATGAGATATCCGAG
ACTCATTTACAGTTAGGCTTAGCCATCACT|CTCGGGTTACACCAATATAGTGGTCTACAC
CGTTTCGTAGTGTTAGCCGGGGCAACACCC|GCTCGACTATGCTATGGCCAGACGCCTGAT
GTCTCTGAAACAATATGTTATACATTAAGA|CTACGATTGCACTGACCACCGTCGTCAGTC
GCTATCCTTGGCTTGCTCTGTTGCGAGCTC|CGGGGCAACGCCGGGGCAACCACTAGATCC
GCCACGATGAGCTTGGGCGCTGAACTTAGC|ACGTAGTGTTAGCCGGGGCAACCGCTATCC
ACGCCTACTGGCAATCTGCTCAACAACCCC|CGTTAGAACACCCCGTTTCGTAGTGTTAGC
GGCAACCGCTATCCCAAATAACGTTAGAAC|TCGCAGTTCGTTAACACCCCGTTTCGTAGT
CAACGTGCCCGAATCTACTAGAAAGTTCTT|CCCCGTTTCGTAGTGTTAGCCGGGGCAACA
TCATTTACAGTTAGGCTTAGCCATCACTGC|CGGGTTACACCAATATAGTGGTCTACACCC
TCTCCACTTACGTAGCTAAGGCAACCCCGT|TCACCCCGTTTCGTAGTGTTAGCCGGGGCA
AACGTGCCCGAATCTACTAGAAAGTTCTTG|CCCGTTTCGTAGTGTTAGCCGGGGCAACAG
TGTACCTAGTATAAGCGCCGAGATCCCCGA|GACCTTTCACTCTCCACTTACGTAGCTAAG
GCTCGTCAAGCCCGTTGCTCTATATTACCC|CCGGGGCAACACCCGCAATGTAAGCGAGCT
CACCGTCGTCAGTCGTTACCACACGCATTA|TGTTAGCACCCCGTTTCGTAGTGTTAGCCG
CTCAAAGGCGCATATGATCGTGTTATTTAC|AGCTTGGGCGCTGAACTTAGCATTTTAGAC
AGACGATAGTGGCCTCTCCTCAAAGGCGCA|TTTCCCTGTGCCACGATGAGCTTGGGCGCT
GTTAGCCGGGGCAACAGGCCTCGGGTTACA|GTGTTAGCCGGGGCAACACTAAGGCCGCGA
CCCCGTTTCGTAGTGTTAACCCCGTTTCGT|GCTTTGTTGGCCTATAGTTAAGTGTACCTA
CGAATCTACTAGAAAGTTCTTGAGGGCAAG|GTAGTGTTAGCCGGGGCAACAGATGTGCTC
ATTCCGGCCTTGCCTGTACTAGGTGCGACC|CTCGGATAATAAACCCATCCGTTAGTCTAG
TTTCGTAGTGTTAGCCGGGGCAACGTGCCC|AAGCCCGTTGCTCTATATTACCCCGTTTCG
CGCAATGTAAGCGAGCTGCGGGAAATGACC|TAGGTTCGTATAGGTCCTGCAACATATAAG
CCTACTGGCAATCTGCTCAACAACCCCGTT|TAGAACACCCCGTTTCGTAGTGTTAGCCGG
GAGTCTGCCTCGTGTAAACTCATTTACAGT|TAGCCGGGGCAACAGGCCTCGGGTTACACC
CCGTCGTCAGTCGTTACCACACGCATTATA|TTAGCACCCCGTTTCGTAGTGTTAGCCGGG
GGGCAACGGCGTGCATCCTCGGATAATAAA|GAGAGCCCCGACGCGAGCTTGGGGGCAATT
GCAAAATTCCGGCCTTGCCTGTACTAGGTG|GCATCCTCGGATAATAAACCCATCCGTTAG
TAGTGGGTAAATAGACGATAGTGGCCTCTC|CGCATTATAAACTTTCCCTGTGCCACGATG
GTTAGCCGGGGCAACTCGCTCTCTTAGGTC|CCTGTACTAGGTGCGACCCCGTTTCGTAGT
GGGCAACCGGGGCAACGTAGTGTTAGCCGG|CTGTTGCGAGCTCCGTCAACGCTAGATCGT
GTAGTGTTAACCCCGTTTCGTAGTGTTAGC|GCCTATAGTTAAGTGTACCTAGTATAAGCG
GGCCCGCGAAAGGTGTAGGTTAATGAGATA|TAGTGTTAGCCGGGGCAACTCGCTCTCTTA
CTAGATCCGGAGTCTGCCTCGTGTAAACTC|TCGTAGTGTTAGCCGGGGCAACAGGCCTCG
TAGCCGGGGCAACAGGCCTCGGGTTACACC|GTTAGCCGGGGCAACACTAAGGCCGCGAGG
GTGTTAGCCGGGGCAACGTGCCCGAATCTA|TTGCTCTATATTACCCCGTTTCGTAGTGTT
GTAGTGTTAGCCGGGGCAACGCCGGGGCAA|TAGTATAAGCGCCGAGATCCCCGAAACCCC
GTGTTAGCCGGGGCAACACCCGCAATGTAA|TGCTATGGCCAGACGCCTGATAGGTTCGTA
TTCGTAGTGTTAGCCGGGGCAACACCCGCA|CGACTATGCTATGGCCAGACGCCTGATAGG
TATCCTTGGCTTGCTCTGTTGCGAGCTCCG|GGGCAACGCCGGGGCAACCACTAGATCCGG
GCGCCGAGATCCCCGAAACCCCGTTTCGTA|CACTTACGTAGCTAAGGCAACCCCGTTTCG
CTACGATTGCACTGACCACCGTCGTCAGTC|TCACCCCGTTTCGTAGTGTTAGCACCCCGT
TTCGTAGTGTTAGCCGGGGCAACACGGATC|GGGGCAACCCCGTTTCGTAGTGTTAACCCC
ACCCCGTTTCGTAGTGTTAGCACCCCGTTT|CAACACGGATCTACTGTCACTGTTCGGGCT
CCCGTTTCGTAGTGTTAGCACCCCGTTTCG|ACACGGATCTACTGTCACTGTTCGGGCTAT
TTAAGTGTACCTAGTATAAGCGCCGAGATC|GCAACGACCTTTCACTCTCCACTTACGTAG
CTCAACAACCCCGTTTCACCCCGTTTCGTA|CGTAGTGTTAGCCGGGGCAACACGGATCTA
GGAGTCTGCCTCGTGTAAACTCATTTACAG|TTAGCCGGGGCAACAGGCCTCGGGTTACAC
GTTTCGTAGTGTTAGCCGGGGCAACGGCGT|ACCCCCGAAACTCCTCTGGAGAGCCCCGAC
TGTTAGCCGGGGCAACCGGGGCAACGTAGT|TGGCTTGCTCTGTTGCGAGCTCCGTCAACG
TACACCAATATAGTGGTCTACACCCCAAAC|GCGAGGTCAGTGACTGTGTTAGGATAGAAG
TTATAAACTTTCCCTGTGCCACGATGAGCT|CCGGGGCAACCGGGGCAACGTAGTGTTAGC
TGTTAGCCGGGGCAACAGGCCTCGGGTTAC|AGTGTTAGCCGGGGCAACACTAAGGCCGCG
TTTCGTAGTGTTAGCCGGGGCAACACCCGC|TCGACTATGCTATGGCCAGACGCCTGATAG
AATAACGTTAGAACACCCCGTTTCGTAGTG|CCCCGTTTCGTAGTGTTAGCCGGGGCAACC
TGCCTGTACTAGGTGCGACCCCGTTTCGTA|AAACCCATCCGTTAGTCTAGAGCTCGACTA
GTAAATAGACGATAGTGGCCTCTCCTCAAA|ATAAACTTTCCCTGTGCCACGATGAGCTTG
CAACACCCGCAATGTAAGCGAGCTGCGGGA|CGCCTGATAGGTTCGTATAGGTCCTGCAAC
CCGGGGCAACACGGATCTACTGTCACTGTT|TTCGTAGTGTTAACCCCGTTTCGTAGTGTT
ATACATTAAGAAAATGACCATAGTGGGTAA|CGTCGTCAGTCGTTACCACACGCATTATAA
GTTAATGAGATATCCGAGATTCACCCCGTT|CTCGCTCTCTTAGGTCTTTAGGCTCGTCAA
TATGTTATACATTAAGAAAATGACCATAGT|GACCACCGTCGTCAGTCGTTACCACACGCA
GTTAGCCGGGGCAACGACCTTTCACTCTCC|TGTAGGTTAATGAGATATCCGAGATTCACC
TAGAAAGTTCTTGAGGGCAAGACACGAATC|GCCGGGGCAACAGATGTGCTCGGAGCATTA
CCGTTTCGTAGTGTTAGCCGGGGCAACCGG|CGGGCTATCCTTGGCTTGCTCTGTTGCGAG
TCGCTCTCTTAGGTCTTTAGGCTCGTCAAG|ACCCCGTTTCGTAGTGTTAGCCGGGGCAAC
ACTCTCCACTTACGTAGCTAAGGCAACCCC|ATTCACCCCGTTTCGTAGTGTTAGCCGGGG
CAAGACACGAATCTCCATACCCCGTTTCGT|GCTCGGAGCATTAGGAGCAAAATTCCGGCC
GTAGTGTTAGCCGGGGCAACCGGGGCAACG|TCCTTGGCTTGCTCTGTTGCGAGCTCCGTC
GCCGGGGCAACCGCTATCCCAAATAACGTT|ATCGTTCGCAGTTCGTTAACACCCCGTTTC
TTAGGCTCGTCAAGCCCGTTGCTCTATATT|TTAGCCGGGGCAACACCCGCAATGTAAGCG
TTTCGTAGTGTTAGCCGGGGCAACCCCGTT|AGCCATCACTGCAAACCGTCTGGGCTTTGT
GTGTTAGCCGGGGCAACACGGATCTACTGT|ACCCCGTTTCGTAGTGTTAACCCCGTTTCG
CAGTGACTGTGTTAGGATAGAAGGGCCCGC|ACGAATCTCCATACCCCGTTTCGTAGTGTT
GCGAGCTGCGGGAAATGACCACCCCGTTTC|TAGGTCCTGCAACATATAAGCAAAGACCCC
CTACTAGAAAGTTCTTGAGGGCAAGACACG|GTTAGCCGGGGCAACAGATGTGCTCGGAGC
GTGCCCGAATCTACTAGAAAGTTCTTGAGG|GTTTCGTAGTGTTAGCCGGGGCAACAGATG
CGTAGTGTTAGCCGGGGCAACACTAAGGCC|GTGCCCGAATCTACTAGAAAGTTCTTGAGG
GCAACCCCGTTTCGTAGTGTTAACCCCGTT|CTGGGCTTTGTTGGCCTATAGTTAAGTGTA
GGCAACACCCGCAATGTAAGCGAGCTGCGG|GACGCCTGATAGGTTCGTATAGGTCCTGCA
CCGGGGCAACCACTAGATCCGGAGTCTGCC|CGAAACCCCGTTTCGTAGTGTTAGCCGGGG
CTGGCAATCTGCTCAACAACCCCGTTTCAC|ACACCCCGTTTCGTAGTGTTAGCCGGGGCA
CAGCAGGCTACGATTGCACTGACCACCGTC|CCCCGTTTCACCCCGTTTCGTAGTGTTAGC
TGGGCGCTGAACTTAGCATTTTAGACGCCT|CGGGGCAACCGCTATCCCAAATAACGTTAG
TTGCCTGTACTAGGTGCGACCCCGTTTCGT|TAAACCCATCCGTTAGTCTAGAGCTCGACT
AATCTACTAGAAAGTTCTTGAGGGCAAGAC|AGTGTTAGCCGGGGCAACAGATGTGCTCGG
AGGTCTTTAGGCTCGTCAAGCCCGTTGCTC|GTAGTGTTAGCCGGGGCAACACCCGCAATG
GCATATGATCGTGTTATTTACATGACGCAC|GCTGAACTTAGCATTTTAGACGCCTACTGG
GGGTTACACCAATATAGTGGTCTACACCCC|GGCCGCGAGGTCAGTGACTGTGTTAGGATA
GGCTATCCTTGGCTTGCTCTGTTGCGAGCT|CCGGGGCAACGCCGGGGCAACCACTAGATC
TGTGCCACGATGAGCTTGGGCGCTGAACTT|GCAACGTAGTGTTAGCCGGGGCAACCGCTA
CCGGGGCAACCCCGTTTCGTAGTGTTAACC|ACCGTCTGGGCTTTGTTGGCCTATAGTTAA
AAATTCCGGCCTTGCCTGTACTAGGTGCGA|TCCTCGGATAATAAACCCATCCGTTAGTCT
GCCGGGGCAACCCCGTTTCGTAGTGTTAAC|AACCGTCTGGGCTTTGTTGGCCTATAGTTA
AATTCAATCAAGGTAGATATGGTCGGTCTC|CACTGCTCGAGCGGGTGACAGCAGGCTACG
AATGAGATATCCGAGATTCACCCCGTTTCG|GCTCTCTTAGGTCTTTAGGCTCGTCAAGCC
TGTTAGGATAGAAGGGCCCGCGAAAGGTGT|CATACCCCGTTTCGTAGTGTTAGCCGGGGC
GTGTTAGCCGGGGCAACAGATGTGCTCGGA|GACCACCCCGTTTCGTAGTGTTAGCCGGGG
AGTGACTGTGTTAGGATAGAAGGGCCCGCG|CGAATCTCCATACCCCGTTTCGTAGTGTTA
TAGTGTTAGCCGGGGCAACACCCGCAATGT|TATGCTATGGCCAGACGCCTGATAGGTTCG
AGTGTTAGCACCCCGTTTCGTAGTGTTAGC|ACTGTCACTGTTCGGGCTATCCTTGGCTTG
CAATGTAAGCGAGCTGCGGGAAATGACCAC|GGTTCGTATAGGTCCTGCAACATATAAGCA
GCTCTGTTGCGAGCTCCGTCAACGCTAGAT|GGCAACCACTAGATCCGGAGTCTGCCTCGT
CCATCACTGCAAACCGTCTGGGCTTTGTTG|GTCTACACCCCAAACCCCGTTTCGTAGTGT
GTTAGCCGGGGCAACGTGCCCGAATCTACT|GCTCTATATTACCCCGTTTCGTAGTGTTAG
AGTGTTAGCCGGGGCAACGGCGTGCATCCT|AAACTCCTCTGGAGAGCCCCGACGCGAGCT
TATTTACATGACGCACTGCTCGAGCGGGTG|TTTAGACGCCTACTGGCAATCTGCTCAACA
CCGAGATCCCCGAAACCCCGTTTCGTAGTG|TTACGTAGCTAAGGCAACCCCGTTTCGTAG
CGCTCTCTTAGGTCTTTAGGCTCGTCAAGC|CCCCGTTTCGTAGTGTTAGCCGGGGCAACA
TGTTAGCCGGGGCAACCGCTATCCCAAATA|GCTAGATCGTTCGCAGTTCGTTAACACCCC
GTTAGCCGGGGCAACACGGATCTACTGTCA|CCCGTTTCGTAGTGTTAACCCCGTTTCGTA
CCCCGTTTCGTAGTGTTAGCCGGGGCAACG|TCGTCAAGCCCGTTGCTCTATATTACCCCG
AACTTTCCCTGTGCCACGATGAGCTTGGGC|GCAACCGGGGCAACGTAGTGTTAGCCGGGG
AACCACTAGATCCGGAGTCTGCCTCGTGTA|CCGTTTCGTAGTGTTAGCCGGGGCAACAGG
CAACGACCTTTCACTCTCCACTTACGTAGC|GAGATATCCGAGATTCACCCCGTTTCGTAG
AGCATTTTAGACGCCTACTGGCAATCTGCT|TCCCAAATAACGTTAGAACACCCCGTTTCG
CCGCGAAAGGTGTAGGTTAATGAGATATCC|TGTTAGCCGGGGCAACTCGCTCTCTTAGGT
TAGAAGGGCCCGCGAAAGGTGTAGGTTAAT|GTTTCGTAGTGTTAGCCGGGGCAACTCGCT
GAACTTAGCATTTTAGACGCCTACTGGCAA|CCGCTATCCCAAATAACGTTAGAACACCCC
TGTTAACCCCGTTTCGTAGTGTTAGCCGGG|ATAGTTAAGTGTACCTAGTATAAGCGCCGA
AACTCGCTCTCTTAGGTCTTTAGGCTCGTC|GCGACCCCGTTTCGTAGTGTTAGCCGGGGC
TAGCCGGGGCAACCCCGTTTCGTAGTGTTA|CAAACCGTCTGGGCTTTGTTGGCCTATAGT
TGTTATACATTAAGAAAATGACCATAGTGG|CCACCGTCGTCAGTCGTTACCACACGCATT
CACGATGAGCTTGGGCGCTGAACTTAGCAT|GTAGTGTTAGCCGGGGCAACCGCTATCCCA
TAGCCGGGGCAACCGGGGCAACGTAGTGTT|CTTGCTCTGTTGCGAGCTCCGTCAACGCTA
CGACCCCGTTTCGTAGTGTTAGCCGGGGCA|TCTAGAGCTCGACTATGCTATGGCCAGACG
GGCAACGGCGTGCATCCTCGGATAATAAAC|AGAGCCCCGACGCGAGCTTGGGGGCAATTC
CGAAAGGTGTAGGTTAATGAGATATCCGAG|TAGCCGGGGCAACTCGCTCTCTTAGGTCTT
TGGGCTTTGTTGGCCTATAGTTAAGTGTAC|GTTTCGTAGTGTTAGCCGGGGCAACGACCT
CGAGATCCCCGAAACCCCGTTTCGTAGTGT|TACGTAGCTAAGGCAACCCCGTTTCGTAGT
TTCGTAGTGTTAGCCGGGGCAACAGATGTG|GGAAATGACCACCCCGTTTCGTAGTGTTAG
AACCCCGTTTCGTAGTGTTAACCCCGTTTC|GGGCTTTGTTGGCCTATAGTTAAGTGTACC
CGTAGTGTTAGCCGGGGCAACACGGATCTA|GGCAACCCCGTTTCGTAGTGTTAACCCCGT
ACAATATGTTATACATTAAGAAAATGACCA|CACTGACCACCGTCGTCAGTCGTTACCACA
CTCGTCAAGCCCGTTGCTCTATATTACCCC|CGGGGCAACACCCGCAATGTAAGCGAGCTG
ACCCCGTTTCGTAGTGTTAGCCGGGGCAAC|CGGGGCAACGTGCCCGAATCTACTAGAAAG
TAAACTCATTTACAGTTAGGCTTAGCCATC|GGCCTCGGGTTACACCAATATAGTGGTCTA
CGTTCGCAGTTCGTTAACACCCCGTTTCGT|GTAAACTCATTTACAGTTAGGCTTAGCCAT
GCGGGAAATGACCACCCCGTTTCGTAGTGT|TGCAACATATAAGCAAAGACCCCCGAAACT
TTTCGTAGTGTTAGCCGGGGCAACGACCTT|CGCGAAAGGTGTAGGTTAATGAGATATCCG
ACCTAGTATAAGCGCCGAGATCCCCGAAAC|CTTTCACTCTCCACTTACGTAGCTAAGGCA
CGTCGTCAGTCGTTACCACACGCATTATAA|TAGCACCCCGTTTCGTAGTGTTAGCCGGGG
CCCGTTTCGTAGTGTTAGCCGGGGCAACGG|AAGACCCCCGAAACTCCTCTGGAGAGCCCC
TTAGGAGCAAAATTCCGGCCTTGCCTGTAC|CGGCGTGCATCCTCGGATAATAAACCCATC
CTGCTCGAGCGGGTGACAGCAGGCTACGAT|GCAATCTGCTCAACAACCCCGTTTCACCCC
AGCCCGTTGCTCTATATTACCCCGTTTCGT|ACACCCGCAATGTAAGCGAGCTGCGGGAAA
CGTTTCGTAGTGTTAGCCGGGGCAACGACC|CCCGCGAAAGGTGTAGGTTAATGAGATATC
CCCGTTTCGTAGTGTTAGCCGGGGCAACAG|CTGCGGGAAATGACCACCCCGTTTCGTAGT
TTAGAACACCCCGTTTCGTAGTGTTAGCCG|TCGTAGTGTTAGCCGGGGCAACCCCGTTTC
AGGAGCAAAATTCCGGCCTTGCCTGTACTA|GCGTGCATCCTCGGATAATAAACCCATCCG
TAGGTTAATGAGATATCCGAGATTCACCCC|CAACTCGCTCTCTTAGGTCTTTAGGCTCGT
GTGACAGCAGGCTACGATTGCACTGACCAC|ACAACCCCGTTTCACCCCGTTTCGTAGTGT
GGCAACACGGATCTACTGTCACTGTTCGGG|TAGTGTTAACCCCGTTTCGTAGTGTTAGCC
GTTAGCCGGGGCAACACCCGCAATGTAAGC|CTATGGCCAGACGCCTGATAGGTTCGTATA
ATTGCACTGACCACCGTCGTCAGTCGTTAC|CCGTTTCGTAGTGTTAGCACCCCGTTTCGT
CATTTACAGTTAGGCTTAGCCATCACTGCA|GGGTTACACCAATATAGTGGTCTACACCCC
AGGTGCGACCCCGTTTCGTAGTGTTAGCCG|GTTAGTCTAGAGCTCGACTATGCTATGGCC
TAGTGTTAGCCGGGGCAACCGGGGCAACGT|CCTTGGCTTGCTCTGTTGCGAGCTCCGTCA
ATCTCCATACCCCGTTTCGTAGTGTTAGCC|TTAGGAGCAAAATTCCGGCCTTGCCTGTAC
GAGCATTAGGAGCAAAATTCCGGCCTTGCC|GGCAACGGCGTGCATCCTCGGATAATAAAC
TGTTAGCCGGGGCAACAGATGTGCTCGGAG|ACCACCCCGTTTCGTAGTGTTAGCCGGGGC
CTCTATATTACCCCGTTTCGTAGTGTTAGC|ATGTAAGCGAGCTGCGGGAAATGACCACCC
CGCGAAAGGTGTAGGTTAATGAGATATCCG|GTTAGCCGGGGCAACTCGCTCTCTTAGGTC
TAGCCGGGGCAACGGCGTGCATCCTCGGAT|CCTCTGGAGAGCCCCGACGCGAGCTTGGGG
AGCCGGGGCAACTCGCTCTCTTAGGTCTTT|GTACTAGGTGCGACCCCGTTTCGTAGTGTT
GTCTTTAGGCTCGTCAAGCCCGTTGCTCTA|AGTGTTAGCCGGGGCAACACCCGCAATGTA
ATCCCCGAAACCCCGTTTCGTAGTGTTAGC|TAGCTAAGGCAACCCCGTTTCGTAGTGTTA
TGAGGGCAAGACACGAATCTCCATACCCCG|AGATGTGCTCGGAGCATTAGGAGCAAAATT
CGAGCTGCGGGAAATGACCACCCCGTTTCG|AGGTCCTGCAACATATAAGCAAAGACCCCC
CCGTTTCGTAGTGTTAGCCGGGGCAACACT|GGCAACGTGCCCGAATCTACTAGAAAGTTC
TCCCTGTGCCACGATGAGCTTGGGCGCTGA|CGGGGCAACGTAGTGTTAGCCGGGGCAACC
CGTAGTGTTAGCCGGGGCAACGCCGGGGCA|CTAGTATAAGCGCCGAGATCCCCGAAACCC
ACGACCTTTCACTCTCCACTTACGTAGCTA|GATATCCGAGATTCACCCCGTTTCGTAGTG
AGCGAGCTGCGGGAAATGACCACCCCGTTT|ATAGGTCCTGCAACATATAAGCAAAGACCC
CCCGTTTCGTAGTGTTAGCCGGGGCAACCG|TCGGGCTATCCTTGGCTTGCTCTGTTGCGA
TCAAGCCCGTTGCTCTATATTACCCCGTTT|GCAACACCCGCAATGTAAGCGAGCTGCGGG
CGGGGCAACACTAAGGCCGCGAGGTCAGTG|ACTAGAAAGTTCTTGAGGGCAAGACACGAA
TCACTCTCCACTTACGTAGCTAAGGCAACC|AGATTCACCCCGTTTCGTAGTGTTAGCCGG
GTTTCGTAGTGTTAGCCGGGGCAACAGATG|CGGGAAATGACCACCCCGTTTCGTAGTGTT
CGTAGTGTTAGCCGGGGCAACGGCGTGCAT|CCGAAACTCCTCTGGAGAGCCCCGACGCGA
ACCCCGTTTCGTAGTGTTAACCCCGTTTCG|GGCTTTGTTGGCCTATAGTTAAGTGTACCT
ATAGTGGCCTCTCCTCAAAGGCGCATATGA|CTGTGCCACGATGAGCTTGGGCGCTGAACT
GACCACCCCGTTTCGTAGTGTTAGCCGGGG|TAAGCAAAGACCCCCGAAACTCCTCTGGAG
GCCGGGGCAACACTAAGGCCGCGAGGTCAG|CTACTAGAAAGTTCTTGAGGGCAAGACACG
ACCCCGTTTCGTAGTGTTAGCCGGGGCAAC|CAAAGACCCCCGAAACTCCTCTGGAGAGCC
GGAGCATTAGGAGCAAAATTCCGGCCTTGC|GGGCAACGGCGTGCATCCTCGGATAATAAA
CAGTTAGGCTTAGCCATCACTGCAAACCGT|CACCAATATAGTGGTCTACACCCCAAACCC
GCTCGGAGCATTAGGAGCAAAATTCCGGCC|GCCGGGGCAACGGCGTGCATCCTCGGATAA
CACGGATCTACTGTCACTGTTCGGGCTATC|TTAACCCCGTTTCGTAGTGTTAGCCGGGGC
GGTCTCTGAAACAATATGTTATACATTAAG|GCTACGATTGCACTGACCACCGTCGTCAGT
TCCATACCCCGTTTCGTAGTGTTAGCCGGG|GGAGCAAAATTCCGGCCTTGCCTGTACTAG
TTTCGTAGTGTTAACCCCGTTTCGTAGTGT|GTTGGCCTATAGTTAAGTGTACCTAGTATA
GGCAACGACCTTTCACTCTCCACTTACGTA|ATGAGATATCCGAGATTCACCCCGTTTCGT
CCGGGGCAACGACCTTTCACTCTCCACTTA|GTTAATGAGATATCCGAGATTCACCCCGTT
GATAGTGGCCTCTCCTCAAAGGCGCATATG|CCTGTGCCACGATGAGCTTGGGCGCTGAAC
ATCCCAAATAACGTTAGAACACCCCGTTTC|TTAACACCCCGTTTCGTAGTGTTAGCCGGG
GTTTCGTAGTGTTAGCCGGGGCAACGTGCC|CAAGCCCGTTGCTCTATATTACCCCGTTTC
GCCGGGGCAACACCCGCAATGTAAGCGAGC|GGCCAGACGCCTGATAGGTTCGTATAGGTC
CCCCGTTTCGTAGTGTTAGCCGGGGCAACG|AAAGACCCCCGAAACTCCTCTGGAGAGCCC
AAGGCAACCCCGTTTCGTAGTGTTAGCCGG|GTTAGCCGGGGCAACGTGCCCGAATCTACT
TCGTAGTGTTAGCACCCCGTTTCGTAGTGT|ATCTACTGTCACTGTTCGGGCTATCCTTGG
AAAATTCCGGCCTTGCCTGTACTAGGTGCG|ATCCTCGGATAATAAACCCATCCGTTAGTC
CGAGATTCACCCCGTTTCGTAGTGTTAGCC|TCTTTAGGCTCGTCAAGCCCGTTGCTCTAT
GGGCAACACGGATCTACTGTCACTGTTCGG|GTAGTGTTAACCCCGTTTCGTAGTGTTAGC
CCGTTTCGTAGTGTTAACCCCGTTTCGTAG|TTTGTTGGCCTATAGTTAAGTGTACCTAGT
ATCTACTGTCACTGTTCGGGCTATCCTTGG|CCCGTTTCGTAGTGTTAGCCGGGGCAACGC
TAGAACACCCCGTTTCGTAGTGTTAGCCGG|CGTAGTGTTAGCCGGGGCAACCCCGTTTCG
CCGTTTCGTAGTGTTAGCCGGGGCAACCCC|CTTAGCCATCACTGCAAACCGTCTGGGCTT
AAGGTAGATATGGTCGGTCTCTGAAACAAT|AGCGGGTGACAGCAGGCTACGATTGCACTG
ACGTGCCCGAATCTACTAGAAAGTTCTTGA|CCGTTTCGTAGTGTTAGCCGGGGCAACAGA
AACGGCGTGCATCCTCGGATAATAAACCCA|GCCCCGACGCGAGCTTGGGGGCAATTCGTA
CAACAGATGTGCTCGGAGCATTAGGAGCAA|CGTAGTGTTAGCCGGGGCAACGGCGTGCAT
ACGTAGTGTTAGCCGGGGCAACCGCTATCC|GTCAACGCTAGATCGTTCGCAGTTCGTTAA
AATATGTTATACATTAAGAAAATGACCATA|CTGACCACCGTCGTCAGTCGTTACCACACG
CGTAGTGTTAGCCGGGGCAACAGATGTGCT|AAATGACCACCCCGTTTCGTAGTGTTAGCC
TAAGAAAATGACCATAGTGGGTAAATAGAC|CAGTCGTTACCACACGCATTATAAACTTTC
TAAGGCAACCCCGTTTCGTAGTGTTAGCCG|TGTTAGCCGGGGCAACGTGCCCGAATCTAC
CGACCTTTCACTCTCCACTTACGTAGCTAA|ATATCCGAGATTCACCCCGTTTCGTAGTGT
AATTCCGGCCTTGCCTGTACTAGGTGCGAC|CCTCGGATAATAAACCCATCCGTTAGTCTA
CCCGTTTCGTAGTGTTAGCCGGGGCAACGA|GGCCCGCGAAAGGTGTAGGTTAATGAGATA
CTTTGTTGGCCTATAGTTAAGTGTACCTAG|CGTAGTGTTAGCCGGGGCAACGACCTTTCA
AGTGTTAGCCGGGGCAACGTGCCCGAATCT|GTTGCTCTATATTACCCCGTTTCGTAGTGT
GCAACACGGATCTACTGTCACTGTTCGGGC|AGTGTTAACCCCGTTTCGTAGTGTTAGCCG
CGTAGTGTTAGCCGGGGCAACTCGCTCTCT|GCCTTGCCTGTACTAGGTGCGACCCCGTTT
TCTACTAGAAAGTTCTTGAGGGCAAGACAC|TGTTAGCCGGGGCAACAGATGTGCTCGGAG
ATATGTTATACATTAAGAAAATGACCATAG|TGACCACCGTCGTCAGTCGTTACCACACGC
TAGTGTTAGCCGGGGCAACAGATGTGCTCG|ATGACCACCCCGTTTCGTAGTGTTAGCCGG
GCAACGACCTTTCACTCTCCACTTACGTAG|TGAGATATCCGAGATTCACCCCGTTTCGTA
AGCGGGTGACAGCAGGCTACGATTGCACTG|GCTCAACAACCCCGTTTCACCCCGTTTCGT
ACCACTAGATCCGGAGTCTGCCTCGTGTAA|CGTTTCGTAGTGTTAGCCGGGGCAACAGGC
AGGGCAAGACACGAATCTCCATACCCCGTT|ATGTGCTCGGAGCATTAGGAGCAAAATTCC
GTTAGCCGGGGCAACAGATGTGCTCGGAGC|CCACCCCGTTTCGTAGTGTTAGCCGGGGCA
GTAGATATGGTCGGTCTCTGAAACAATATG|GGGTGACAGCAGGCTACGATTGCACTGACC
GCACTGCTCGAGCGGGTGACAGCAGGCTAC|CTGGCAATCTGCTCAACAACCCCGTTTCAC
AGTATAAGCGCCGAGATCCCCGAAACCCCG|CACTCTCCACTTACGTAGCTAAGGCAACCC
TCCACTTACGTAGCTAAGGCAACCCCGTTT|ACCCCGTTTCGTAGTGTTAGCCGGGGCAAC
TCAAGGTAGATATGGTCGGTCTCTGAAACA|CGAGCGGGTGACAGCAGGCTACGATTGCAC
CGTAGTGTTAGCACCCCGTTTCGTAGTGTT|TCTACTGTCACTGTTCGGGCTATCCTTGGC
CGTTTCGTAGTGTTAGCCGGGGCAACGGCG|GACCCCCGAAACTCCTCTGGAGAGCCCCGA
CTTGAGGGCAAGACACGAATCTCCATACCC|ACAGATGTGCTCGGAGCATTAGGAGCAAAA
AAACTCATTTACAGTTAGGCTTAGCCATCA|GCCTCGGGTTACACCAATATAGTGGTCTAC
TCGTAGTGTTAGCCGGGGCAACACGGATCT|GGGCAACCCCGTTTCGTAGTGTTAACCCCG
GTAGTGTTAGCCGGGGCAACCCCGTTTCGT|ATCACTGCAAACCGTCTGGGCTTTGTTGGC
CGGGGCAACAGGCCTCGGGTTACACCAATA|GCCGGGGCAACACTAAGGCCGCGAGGTCAG
TTAGCCGGGGCAACACTAAGGCCGCGAGGT|AATCTACTAGAAAGTTCTTGAGGGCAAGAC
GACACGAATCTCCATACCCCGTTTCGTAGT|CGGAGCATTAGGAGCAAAATTCCGGCCTTG
TCGTAGTGTTAACCCCGTTTCGTAGTGTTA|TGGCCTATAGTTAAGTGTACCTAGTATAAG
CCGGGGCAACCGCTATCCCAAATAACGTTA|TCGTTCGCAGTTCGTTAACACCCCGTTTCG
TCGTAGTGTTAGCCGGGGCAACACCCGCAA|GACTATGCTATGGCCAGACGCCTGATAGGT
GAAATGACCACCCCGTTTCGTAGTGTTAGC|ACATATAAGCAAAGACCCCCGAAACTCCTC
TGACCACCGTCGTCAGTCGTTACCACACGC|GTAGTGTTAGCACCCCGTTTCGTAGTGTTA
TTAATGAGATATCCGAGATTCACCCCGTTT|TCGCTCTCTTAGGTCTTTAGGCTCGTCAAG
TATTACCCCGTTTCGTAGTGTTAGCCGGGG|AGCGAGCTGCGGGAAATGACCACCCCGTTT
AACTCATTTACAGTTAGGCTTAGCCATCAC|CCTCGGGTTACACCAATATAGTGGTCTACA
CCCCGTTTCGTAGTGTTAGCCGGGGCAACA|GCTGCGGGAAATGACCACCCCGTTTCGTAG
GTCACTGTTCGGGCTATCCTTGGCTTGCTC|CGTAGTGTTAGCCGGGGCAACGCCGGGGCA
TAACGTTAGAACACCCCGTTTCGTAGTGTT|CCGTTTCGTAGTGTTAGCCGGGGCAACCCC
GAGCTTGGGCGCTGAACTTAGCATTTTAGA|TTAGCCGGGGCAACCGCTATCCCAAATAAC
AATCTCCATACCCCGTTTCGTAGTGTTAGC|ATTAGGAGCAAAATTCCGGCCTTGCCTGTA
CCCCGTTTCACCCCGTTTCGTAGTGTTAGC|TAGCCGGGGCAACACGGATCTACTGTCACT
TGACTGTGTTAGGATAGAAGGGCCCGCGAA|AATCTCCATACCCCGTTTCGTAGTGTTAGC
CGATTGCACTGACCACCGTCGTCAGTCGTT|CCCCGTTTCGTAGTGTTAGCACCCCGTTTC
GACGCCTACTGGCAATCTGCTCAACAACCC|ACGTTAGAACACCCCGTTTCGTAGTGTTAG
TGGCAATCTGCTCAACAACCCCGTTTCACC|CACCCCGTTTCGTAGTGTTAGCCGGGGCAA
CGGGGCAACTCGCTCTCTTAGGTCTTTAGG|CTAGGTGCGACCCCGTTTCGTAGTGTTAGC
TAGCACCCCGTTTCGTAGTGTTAGCCGGGG|CACTGTTCGGGCTATCCTTGGCTTGCTCTG
GTTGCTCTATATTACCCCGTTTCGTAGTGT|CGCAATGTAAGCGAGCTGCGGGAAATGACC
TAGTGGTCTACACCCCAAACCCCGTTTCGT|TGACTGTGTTAGGATAGAAGGGCCCGCGAA
CCCGTTTCGTAGTGTTAGCCGGGGCAACGT|CGTCAAGCCCGTTGCTCTATATTACCCCGT
TCCCAAATAACGTTAGAACACCCCGTTTCG|TAACACCCCGTTTCGTAGTGTTAGCCGGGG
AACACCCCGTTTCGTAGTGTTAGCCGGGGC|GTTAGGCTTAGCCATCACTGCAAACCGTCT
TCGAGCGGGTGACAGCAGGCTACGATTGCA|TCTGCTCAACAACCCCGTTTCACCCCGTTT
GGGGCAACAGGCCTCGGGTTACACCAATAT|CCGGGGCAACACTAAGGCCGCGAGGTCAGT
AGTGGCCTCTCCTCAAAGGCGCATATGATC|GTGCCACGATGAGCTTGGGCGCTGAACTTA
TGCTCTGTTGCGAGCTCCGTCAACGCTAGA|GGGCAACCACTAGATCCGGAGTCTGCCTCG
AAAGGTGTAGGTTAATGAGATATCCGAGAT|GCCGGGGCAACTCGCTCTCTTAGGTCTTTA
CCCCGTTTCGTAGTGTTAGCCGGGGCAACA|TTAGCCGGGGCAACCCCGTTTCGTAGTGTT
CTCATTTACAGTTAGGCTTAGCCATCACTG|TCGGGTTACACCAATATAGTGGTCTACACC
GCTTGGGCGCTGAACTTAGCATTTTAGACG|AGCCGGGGCAACCGCTATCCCAAATAACGT
GGCAACAGGCCTCGGGTTACACCAATATAG|GGGGCAACACTAAGGCCGCGAGGTCAGTGA
AGACGCCTACTGGCAATCTGCTCAACAACC|AACGTTAGAACACCCCGTTTCGTAGTGTTA
GCTACGATTGCACTGACCACCGTCGTCAGT|TTCACCCCGTTTCGTAGTGTTAGCACCCCG
TAGCCGGGGCAACACCCGCAATGTAAGCGA|ATGGCCAGACGCCTGATAGGTTCGTATAGG
GCAGGCTACGATTGCACTGACCACCGTCGT|CCGTTTCACCCCGTTTCGTAGTGTTAGCAC
ATCGTTCGCAGTTCGTTAACACCCCGTTTC|GTGTAAACTCATTTACAGTTAGGCTTAGCC
CTATCCTTGGCTTGCTCTGTTGCGAGCTCC|GGGGCAACGCCGGGGCAACCACTAGATCCG
TCCGGCCTTGCCTGTACTAGGTGCGACCCC|CGGATAATAAACCCATCCGTTAGTCTAGAG
TCGTCAGTCGTTACCACACGCATTATAAAC|GCACCCCGTTTCGTAGTGTTAGCCGGGGCA
TATAGTGGTCTACACCCCAAACCCCGTTTC|AGTGACTGTGTTAGGATAGAAGGGCCCGCG
GTTGGCCTATAGTTAAGTGTACCTAGTATA|GTGTTAGCCGGGGCAACGACCTTTCACTCT
TTCGTAGTGTTAGCCGGGGCAACGACCTTT|GCGAAAGGTGTAGGTTAATGAGATATCCGA
CGGGGCAACACCCGCAATGTAAGCGAGCTG|CCAGACGCCTGATAGGTTCGTATAGGTCCT
AAACAATATGTTATACATTAAGAAAATGAC|TGCACTGACCACCGTCGTCAGTCGTTACCA
GTGTAAACTCATTTACAGTTAGGCTTAGCC|ACAGGCCTCGGGTTACACCAATATAGTGGT
TAGTGTTAACCCCGTTTCGTAGTGTTAGCC|CCTATAGTTAAGTGTACCTAGTATAAGCGC
GTCTGGGCTTTGTTGGCCTATAGTTAAGTG|CCCGTTTCGTAGTGTTAGCCGGGGCAACGA
CATTAGGAGCAAAATTCCGGCCTTGCCTGT|AACGGCGTGCATCCTCGGATAATAAACCCA
GCGAGCTCCGTCAACGCTAGATCGTTCGCA|CTAGATCCGGAGTCTGCCTCGTGTAAACTC
CTGAAACAATATGTTATACATTAAGAAAAT|GATTGCACTGACCACCGTCGTCAGTCGTTA
CTATATTACCCCGTTTCGTAGTGTTAGCCG|GTAAGCGAGCTGCGGGAAATGACCACCCCG
CTGTTCGGGCTATCCTTGGCTTGCTCTGTT|GTGTTAGCCGGGGCAACGCCGGGGCAACCA
AACGCTAGATCGTTCGCAGTTCGTTAACAC|TCTGCCTCGTGTAAACTCATTTACAGTTAG
AGTGGTCTACACCCCAAACCCCGTTTCGTA|GACTGTGTTAGGATAGAAGGGCCCGCGAAA
TAGGATAGAAGGGCCCGCGAAAGGTGTAGG|ACCCCGTTTCGTAGTGTTAGCCGGGGCAAC
GGGGCAACTCGCTCTCTTAGGTCTTTAGGC|TAGGTGCGACCCCGTTTCGTAGTGTTAGCC
CCTAGTATAAGCGCCGAGATCCCCGAAACC|TTTCACTCTCCACTTACGTAGCTAAGGCAA
CCAATATAGTGGTCTACACCCCAAACCCCG|GGTCAGTGACTGTGTTAGGATAGAAGGGCC
ATCTACTAGAAAGTTCTTGAGGGCAAGACA|GTGTTAGCCGGGGCAACAGATGTGCTCGGA
CACTCTCCACTTACGTAGCTAAGGCAACCC|GATTCACCCCGTTTCGTAGTGTTAGCCGGG
TGTACTAGGTGCGACCCCGTTTCGTAGTGT|CCATCCGTTAGTCTAGAGCTCGACTATGCT
GTACTAGGTGCGACCCCGTTTCGTAGTGTT|CATCCGTTAGTCTAGAGCTCGACTATGCTA
CTGTCACTGTTCGGGCTATCCTTGGCTTGC|TTCGTAGTGTTAGCCGGGGCAACGCCGGGG
ACCACACGCATTATAAACTTTCCCTGTGCC|GTAGTGTTAGCCGGGGCAACCGGGGCAACG
TAGGAGCAAAATTCCGGCCTTGCCTGTACT|GGCGTGCATCCTCGGATAATAAACCCATCC
CGTTTCGTAGTGTTAGCCGGGGCAACTCGC|TTCCGGCCTTGCCTGTACTAGGTGCGACCC
TTCACCCCGTTTCGTAGTGTTAGCCGGGGC|AGGCTCGTCAAGCCCGTTGCTCTATATTAC
GTCGTTACCACACGCATTATAAACTTTCCC|CGTTTCGTAGTGTTAGCCGGGGCAACCGGG
GGGGCAACCGGGGCAACGTAGTGTTAGCCG|TCTGTTGCGAGCTCCGTCAACGCTAGATCG
CTTACGTAGCTAAGGCAACCCCGTTTCGTA|CGTTTCGTAGTGTTAGCCGGGGCAACGTGC
GCAACGGCGTGCATCCTCGGATAATAAACC|GAGCCCCGACGCGAGCTTGGGGGCAATTCG
GTTTCGTAGTGTTAGCCGGGGCAACGCCGG|GTACCTAGTATAAGCGCCGAGATCCCCGAA
GCTTGCTCTGTTGCGAGCTCCGTCAACGCT|CCGGGGCAACCACTAGATCCGGAGTCTGCC
AGTTCTTGAGGGCAAGACACGAATCTCCAT|GGCAACAGATGTGCTCGGAGCATTAGGAGC
GGGGCAACGACCTTTCACTCTCCACTTACG|TAATGAGATATCCGAGATTCACCCCGTTTC
GTCAAGCCCGTTGCTCTATATTACCCCGTT|GGCAACACCCGCAATGTAAGCGAGCTGCGG
ACGATAGTGGCCTCTCCTCAAAGGCGCATA|TCCCTGTGCCACGATGAGCTTGGGCGCTGA
CCTGTGCCACGATGAGCTTGGGCGCTGAAC|GGGCAACGTAGTGTTAGCCGGGGCAACCGC
ATAGTGGTCTACACCCCAAACCCCGTTTCG|GTGACTGTGTTAGGATAGAAGGGCCCGCGA
CCACACGCATTATAAACTTTCCCTGTGCCA|TAGTGTTAGCCGGGGCAACCGGGGCAACGT
GCAACCGGGGCAACGTAGTGTTAGCCGGGG|GTTGCGAGCTCCGTCAACGCTAGATCGTTC
TAGCCGGGGCAACGCCGGGGCAACCACTAG|AGCGCCGAGATCCCCGAAACCCCGTTTCGT
GCAACCACTAGATCCGGAGTCTGCCTCGTG|CCCCGTTTCGTAGTGTTAGCCGGGGCAACA
GGCGCTGAACTTAGCATTTTAGACGCCTAC|GGGCAACCGCTATCCCAAATAACGTTAGAA
ACCATAGTGGGTAAATAGACGATAGTGGCC|CACACGCATTATAAACTTTCCCTGTGCCAC
ACTAGATCCGGAGTCTGCCTCGTGTAAACT|TTCGTAGTGTTAGCCGGGGCAACAGGCCTC
ACACCCGCAATGTAAGCGAGCTGCGGGAAA|CCTGATAGGTTCGTATAGGTCCTGCAACAT
TGCCACGATGAGCTTGGGCGCTGAACTTAG|AACGTAGTGTTAGCCGGGGCAACCGCTATC
CCACGATGAGCTTGGGCGCTGAACTTAGCA|CGTAGTGTTAGCCGGGGCAACCGCTATCCC
CACGCATTATAAACTTTCCCTGTGCCACGA|TGTTAGCCGGGGCAACCGGGGCAACGTAGT
TTGAGGGCAAGACACGAATCTCCATACCCC|CAGATGTGCTCGGAGCATTAGGAGCAAAAT
CAAAATTCCGGCCTTGCCTGTACTAGGTGC|CATCCTCGGATAATAAACCCATCCGTTAGT
AGCGCCGAGATCCCCGAAACCCCGTTTCGT|CCACTTACGTAGCTAAGGCAACCCCGTTTC
TTCGTAGTGTTAACCCCGTTTCGTAGTGTT|TTGGCCTATAGTTAAGTGTACCTAGTATAA
CTGTGCCACGATGAGCTTGGGCGCTGAACT|GGCAACGTAGTGTTAGCCGGGGCAACCGCT
CCGCTATCCCAAATAACGTTAGAACACCCC|GTTCGTTAACACCCCGTTTCGTAGTGTTAG
TATGGTCGGTCTCTGAAACAATATGTTATA|ACAGCAGGCTACGATTGCACTGACCACCGT
TACCCCGTTTCGTAGTGTTAGCCGGGGCAA|GAGCTGCGGGAAATGACCACCCCGTTTCGT
CCCCGTTTCGTAGTGTTAGCCGGGGCAACG|GGGCCCGCGAAAGGTGTAGGTTAATGAGAT
GTGTTAGCCGGGGCAACAGGCCTCGGGTTA|TAGTGTTAGCCGGGGCAACACTAAGGCCGC
TGTTAGCCGGGGCAACACGGATCTACTGTC|CCCCGTTTCGTAGTGTTAACCCCGTTTCGT
GTGTTAGCCGGGGCAACGACCTTTCACTCT|GGTGTAGGTTAATGAGATATCCGAGATTCA
CGTAGTGTTAGCCGGGGCAACCGGGGCAAC|ATCCTTGGCTTGCTCTGTTGCGAGCTCCGT
CACCCCAAACCCCGTTTCGTAGTGTTAGCC|AGGATAGAAGGGCCCGCGAAAGGTGTAGGT
CACTTACGTAGCTAAGGCAACCCCGTTTCG|CCCGTTTCGTAGTGTTAGCCGGGGCAACGT
GAATTCAATCAAGGTAGATATGGTCGGTCT|GCACTGCTCGAGCGGGTGACAGCAGGCTAC
CGGGGCAACCACTAGATCCGGAGTCTGCCT|GAAACCCCGTTTCGTAGTGTTAGCCGGGGC
AAAATGACCATAGTGGGTAAATAGACGATA|CGTTACCACACGCATTATAAACTTTCCCTG
TCTCTTAGGTCTTTAGGCTCGTCAAGCCCG|CGTTTCGTAGTGTTAGCCGGGGCAACACCC
TCGCAGTTCGTTAACACCCCGTTTCGTAGT|AACTCATTTACAGTTAGGCTTAGCCATCAC
GGTTAATGAGATATCCGAGATTCACCCCGT|ACTCGCTCTCTTAGGTCTTTAGGCTCGTCA
GCCGGGGCAACCACTAGATCCGGAGTCTGC|CCGAAACCCCGTTTCGTAGTGTTAGCCGGG
GTTAGCCGGGGCAACCGCTATCCCAAATAA|CTAGATCGTTCGCAGTTCGTTAACACCCCG
TTGGCCTATAGTTAAGTGTACCTAGTATAA|TGTTAGCCGGGGCAACGACCTTTCACTCTC
TAGGTGCGACCCCGTTTCGTAGTGTTAGCC|CGTTAGTCTAGAGCTCGACTATGCTATGGC
CGTTTCGTAGTGTTAGCACCCCGTTTCGTA|ACGGATCTACTGTCACTGTTCGGGCTATCC
TAAGGCCGCGAGGTCAGTGACTGTGTTAGG|CTTGAGGGCAAGACACGAATCTCCATACCC
CCGTTTCACCCCGTTTCGTAGTGTTAGCAC|GCCGGGGCAACACGGATCTACTGTCACTGT
ACTAGGTGCGACCCCGTTTCGTAGTGTTAG|TCCGTTAGTCTAGAGCTCGACTATGCTATG
GCGCATATGATCGTGTTATTTACATGACGC|GCGCTGAACTTAGCATTTTAGACGCCTACT
CCGGCCTTGCCTGTACTAGGTGCGACCCCG|GGATAATAAACCCATCCGTTAGTCTAGAGC
GATTCACCCCGTTTCGTAGTGTTAGCCGGG|TTAGGCTCGTCAAGCCCGTTGCTCTATATT
CTTTAGGCTCGTCAAGCCCGTTGCTCTATA|TGTTAGCCGGGGCAACACCCGCAATGTAAG
TTCAATCAAGGTAGATATGGTCGGTCTCTG|CTGCTCGAGCGGGTGACAGCAGGCTACGAT
TTCCCTGTGCCACGATGAGCTTGGGCGCTG|CCGGGGCAACGTAGTGTTAGCCGGGGCAAC
TATAAGCGCCGAGATCCCCGAAACCCCGTT|CTCTCCACTTACGTAGCTAAGGCAACCCCG
AGGCAACCCCGTTTCGTAGTGTTAGCCGGG|TTAGCCGGGGCAACGTGCCCGAATCTACTA
ATGACGCACTGCTCGAGCGGGTGACAGCAG|GCCTACTGGCAATCTGCTCAACAACCCCGT
GGGCAACCCCGTTTCGTAGTGTTAACCCCG|GTCTGGGCTTTGTTGGCCTATAGTTAAGTG
GCCGGGGCAACAGGCCTCGGGTTACACCAA|TAGCCGGGGCAACACTAAGGCCGCGAGGTC
AGTTAGGCTTAGCCATCACTGCAAACCGTC|ACCAATATAGTGGTCTACACCCCAAACCCC
TCTTAGGTCTTTAGGCTCGTCAAGCCCGTT|TTTCGTAGTGTTAGCCGGGGCAACACCCGC
GCACCCCGTTTCGTAGTGTTAGCCGGGGCA|CTGTTCGGGCTATCCTTGGCTTGCTCTGTT
CCCGTTTCGTAGTGTTAACCCCGTTTCGTA|CTTTGTTGGCCTATAGTTAAGTGTACCTAG
GGCAACCCCGTTTCGTAGTGTTAGCCGGGG|TAGCCGGGGCAACGTGCCCGAATCTACTAG
CCACTAGATCCGGAGTCTGCCTCGTGTAAA|GTTTCGTAGTGTTAGCCGGGGCAACAGGCC
ACACCCCGTTTCGTAGTGTTAGCCGGGGCA|GTGTTAGCCGGGGCAACCCCGTTTCGTAGT
CCAAACCCCGTTTCGTAGTGTTAGCCGGGG|TAGAAGGGCCCGCGAAAGGTGTAGGTTAAT
CGGAGTCTGCCTCGTGTAAACTCATTTACA|GTTAGCCGGGGCAACAGGCCTCGGGTTACA
TACACCCCAAACCCCGTTTCGTAGTGTTAG|TTAGGATAGAAGGGCCCGCGAAAGGTGTAG
CCGGGGCAACACTAAGGCCGCGAGGTCAGT|TACTAGAAAGTTCTTGAGGGCAAGACACGA
CATGACGCACTGCTCGAGCGGGTGACAGCA|CGCCTACTGGCAATCTGCTCAACAACCCCG
AAATGACCATAGTGGGTAAATAGACGATAG|GTTACCACACGCATTATAAACTTTCCCTGT
CGTAGTGTTAGCCGGGGCAACACCCGCAAT|ACTATGCTATGGCCAGACGCCTGATAGGTT
TTTACAGTTAGGCTTAGCCATCACTGCAAA|GTTACACCAATATAGTGGTCTACACCCCAA
GCCGGGGCAACGACCTTTCACTCTCCACTT|GGTTAATGAGATATCCGAGATTCACCCCGT
GGTGTAGGTTAATGAGATATCCGAGATTCA|GGGGCAACTCGCTCTCTTAGGTCTTTAGGC
CGTTTCGTAGTGTTAGCCGGGGCAACAGGC|CCCGTTTCGTAGTGTTAGCCGGGGCAACAC
TATCCCAAATAACGTTAGAACACCCCGTTT|GTTAACACCCCGTTTCGTAGTGTTAGCCGG
CGGAGCATTAGGAGCAAAATTCCGGCCTTG|GGGGCAACGGCGTGCATCCTCGGATAATAA
GGGTGACAGCAGGCTACGATTGCACTGACC|CAACAACCCCGTTTCACCCCGTTTCGTAGT
GTTTCGTAGTGTTAGCCGGGGCAACACCCG|CTCGACTATGCTATGGCCAGACGCCTGATA
GTGTTATTTACATGACGCACTGCTCGAGCG|GCATTTTAGACGCCTACTGGCAATCTGCTC
ATCTGCTCAACAACCCCGTTTCACCCCGTT|CGTTTCGTAGTGTTAGCCGGGGCAACACGG
AGTCTGCCTCGTGTAAACTCATTTACAGTT|AGCCGGGGCAACAGGCCTCGGGTTACACCA
GCCCGCGAAAGGTGTAGGTTAATGAGATAT|AGTGTTAGCCGGGGCAACTCGCTCTCTTAG
CCCCGTTTCGTAGTGTTAGCACCCCGTTTC|AACACGGATCTACTGTCACTGTTCGGGCTA
TCACCCCGTTTCGTAGTGTTAGCCGGGGCA|GGCTCGTCAAGCCCGTTGCTCTATATTACC
GGGGCAACGGCGTGCATCCTCGGATAATAA|GGAGAGCCCCGACGCGAGCTTGGGGGCAAT
ACACGGATCTACTGTCACTGTTCGGGCTAT|GTTAACCCCGTTTCGTAGTGTTAGCCGGGG
TGTTAGCCGGGGCAACGACCTTTCACTCTC|GTGTAGGTTAATGAGATATCCGAGATTCAC
GTTATACATTAAGAAAATGACCATAGTGGG|CACCGTCGTCAGTCGTTACCACACGCATTA
TTGGGCGCTGAACTTAGCATTTTAGACGCC|CCGGGGCAACCGCTATCCCAAATAACGTTA
CCGGGGCAACACCCGCAATGTAAGCGAGCT|GCCAGACGCCTGATAGGTTCGTATAGGTCC
GGCAAGACACGAATCTCCATACCCCGTTTC|GTGCTCGGAGCATTAGGAGCAAAATTCCGG
TACGATTGCACTGACCACCGTCGTCAGTCG|CACCCCGTTTCGTAGTGTTAGCACCCCGTT
CGTAGTGTTAGCCGGGGCAACGTGCCCGAA|CCCGTTGCTCTATATTACCCCGTTTCGTAG
AAACCCCGTTTCGTAGTGTTAGCCGGGGCA|GGCAACCCCGTTTCGTAGTGTTAGCCGGGG
TAGTGTTAGCCGGGGCAACACGGATCTACT|CAACCCCGTTTCGTAGTGTTAACCCCGTTT
GTCGGTCTCTGAAACAATATGTTATACATT|CAGGCTACGATTGCACTGACCACCGTCGTC
TGTGTTAGGATAGAAGGGCCCGCGAAAGGT|TCCATACCCCGTTTCGTAGTGTTAGCCGGG
GGCCTCTCCTCAAAGGCGCATATGATCGTG|CCACGATGAGCTTGGGCGCTGAACTTAGCA
GTTAAGTGTACCTAGTATAAGCGCCGAGAT|GGCAACGACCTTTCACTCTCCACTTACGTA
GAGCTGCGGGAAATGACCACCCCGTTTCGT|GGTCCTGCAACATATAAGCAAAGACCCCCG
ATAGACGATAGTGGCCTCTCCTCAAAGGCG|ACTTTCCCTGTGCCACGATGAGCTTGGGCG
CGTTAACACCCCGTTTCGTAGTGTTAGCCG|TACAGTTAGGCTTAGCCATCACTGCAAACC
CTCCGTCAACGCTAGATCGTTCGCAGTTCG|TCCGGAGTCTGCCTCGTGTAAACTCATTTA
CGTCAAGCCCGTTGCTCTATATTACCCCGT|GGGCAACACCCGCAATGTAAGCGAGCTGCG
CCCGTTTCGTAGTGTTAGCCGGGGCAACTC|AATTCCGGCCTTGCCTGTACTAGGTGCGAC
AGTGTTAGCCGGGGCAACAGGCCTCGGGTT|GTAGTGTTAGCCGGGGCAACACTAAGGCCG
ATGAGATATCCGAGATTCACCCCGTTTCGT|CTCTCTTAGGTCTTTAGGCTCGTCAAGCCC
ATCAAGGTAGATATGGTCGGTCTCTGAAAC|TCGAGCGGGTGACAGCAGGCTACGATTGCA
CTCGGAGCATTAGGAGCAAAATTCCGGCCT|CCGGGGCAACGGCGTGCATCCTCGGATAAT
ACTCGCTCTCTTAGGTCTTTAGGCTCGTCA|CGACCCCGTTTCGTAGTGTTAGCCGGGGCA
CGGGGCAACGACCTTTCACTCTCCACTTAC|TTAATGAGATATCCGAGATTCACCCCGTTT
AAGCCCGTTGCTCTATATTACCCCGTTTCG|AACACCCGCAATGTAAGCGAGCTGCGGGAA
AAGGCGCATATGATCGTGTTATTTACATGA|TGGGCGCTGAACTTAGCATTTTAGACGCCT
TTTCGTAGTGTTAGCCGGGGCAACTCGCTC|CCGGCCTTGCCTGTACTAGGTGCGACCCCG
GGCAACGTGCCCGAATCTACTAGAAAGTTC|TACCCCGTTTCGTAGTGTTAGCCGGGGCAA
CGCATTATAAACTTTCCCTGTGCCACGATG|TTAGCCGGGGCAACCGGGGCAACGTAGTGT
GTGTTAGCCGGGGCAACGGCGTGCATCCTC|AACTCCTCTGGAGAGCCCCGACGCGAGCTT
ATTAGGAGCAAAATTCCGGCCTTGCCTGTA|ACGGCGTGCATCCTCGGATAATAAACCCAT
GGGCAACCACTAGATCCGGAGTCTGCCTCG|AACCCCGTTTCGTAGTGTTAGCCGGGGCAA
CGGGGCAACCCCGTTTCGTAGTGTTAACCC|CCGTCTGGGCTTTGTTGGCCTATAGTTAAG
GTACCTAGTATAAGCGCCGAGATCCCCGAA|ACCTTTCACTCTCCACTTACGTAGCTAAGG
GGGCAACACCCGCAATGTAAGCGAGCTGCG|AGACGCCTGATAGGTTCGTATAGGTCCTGC
CTCCATACCCCGTTTCGTAGTGTTAGCCGG|AGGAGCAAAATTCCGGCCTTGCCTGTACTA
CCCGCGAAAGGTGTAGGTTAATGAGATATC|GTGTTAGCCGGGGCAACTCGCTCTCTTAGG
GACGCACTGCTCGAGCGGGTGACAGCAGGC|CTACTGGCAATCTGCTCAACAACCCCGTTT
AAACCGTCTGGGCTTTGTTGGCCTATAGTT|CAAACCCCGTTTCGTAGTGTTAGCCGGGGC
TAAATAGACGATAGTGGCCTCTCCTCAAAG|TAAACTTTCCCTGTGCCACGATGAGCTTGG
TCCTCAAAGGCGCATATGATCGTGTTATTT|TGAGCTTGGGCGCTGAACTTAGCATTTTAG
CCTCGTGTAAACTCATTTACAGTTAGGCTT|GGCAACAGGCCTCGGGTTACACCAATATAG
GTTAGCCGGGGCAACGCCGGGGCAACCACT|TAAGCGCCGAGATCCCCGAAACCCCGTTTC
GTGTTAGCCGGGGCAACCGCTATCCCAAAT|CGCTAGATCGTTCGCAGTTCGTTAACACCC
GCCTACTGGCAATCTGCTCAACAACCCCGT|TTAGAACACCCCGTTTCGTAGTGTTAGCCG
CTAGGTGCGACCCCGTTTCGTAGTGTTAGC|CCGTTAGTCTAGAGCTCGACTATGCTATGG
CGATGAGCTTGGGCGCTGAACTTAGCATTT|AGTGTTAGCCGGGGCAACCGCTATCCCAAA
AGCCGGGGCAACAGATGTGCTCGGAGCATT|CCCCGTTTCGTAGTGTTAGCCGGGGCAACG
CCCCGTTTCGTAGTGTTAGCCGGGGCAACG|AAGTGTACCTAGTATAAGCGCCGAGATCCC
AGCCGGGGCAACGGCGTGCATCCTCGGATA|CTCTGGAGAGCCCCGACGCGAGCTTGGGGG
AATGACCATAGTGGGTAAATAGACGATAGT|TTACCACACGCATTATAAACTTTCCCTGTG
TAGTGTTAGCCGGGGCAACGCCGGGGCAAC|AGTATAAGCGCCGAGATCCCCGAAACCCCG
CAACCCCGTTTCGTAGTGTTAACCCCGTTT|TGGGCTTTGTTGGCCTATAGTTAAGTGTAC
ACCGCTATCCCAAATAACGTTAGAACACCC|AGTTCGTTAACACCCCGTTTCGTAGTGTTA
CCTCGGGTTACACCAATATAGTGGTCTACA|CTAAGGCCGCGAGGTCAGTGACTGTGTTAG
TGCAAACCGTCTGGGCTTTGTTGGCCTATA|CCCCAAACCCCGTTTCGTAGTGTTAGCCGG
CAACCACTAGATCCGGAGTCTGCCTCGTGT|CCCGTTTCGTAGTGTTAGCCGGGGCAACAG
ACCCCGTTTCGTAGTGTTAGCCGGGGCAAC|GTTAGCCGGGGCAACCCCGTTTCGTAGTGT
AGCACCCCGTTTCGTAGTGTTAGCCGGGGC|ACTGTTCGGGCTATCCTTGGCTTGCTCTGT
TTGGCTTGCTCTGTTGCGAGCTCCGTCAAC|ACGCCGGGGCAACCACTAGATCCGGAGTCT
GGTTACACCAATATAGTGGTCTACACCCCA|GCCGCGAGGTCAGTGACTGTGTTAGGATAG
TTAGGCTTAGCCATCACTGCAAACCGTCTG|CAATATAGTGGTCTACACCCCAAACCCCGT
TTCACCCCGTTTCGTAGTGTTAGCACCCCG|GGGCAACACGGATCTACTGTCACTGTTCGG
ACCCCGTTTCGTAGTGTTAGCCGGGGCAAC|TAAGTGTACCTAGTATAAGCGCCGAGATCC
CTCGTGTAAACTCATTTACAGTTAGGCTTA|GCAACAGGCCTCGGGTTACACCAATATAGT
GGTCTACACCCCAAACCCCGTTTCGTAGTG|TGTGTTAGGATAGAAGGGCCCGCGAAAGGT
TAGTGTTAGCCGGGGCAACCGCTATCCCAA|AACGCTAGATCGTTCGCAGTTCGTTAACAC
CCCAAACCCCGTTTCGTAGTGTTAGCCGGG|ATAGAAGGGCCCGCGAAAGGTGTAGGTTAA
TAAACTTTCCCTGTGCCACGATGAGCTTGG|GGGCAACCGGGGCAACGTAGTGTTAGCCGG
GGCTTTGTTGGCCTATAGTTAAGTGTACCT|TTCGTAGTGTTAGCCGGGGCAACGACCTTT
CTCCTCAAAGGCGCATATGATCGTGTTATT|ATGAGCTTGGGCGCTGAACTTAGCATTTTA
GGGCAACACTAAGGCCGCGAGGTCAGTGAC|TAGAAAGTTCTTGAGGGCAAGACACGAATC
TAGCTAAGGCAACCCCGTTTCGTAGTGTTA|GTAGTGTTAGCCGGGGCAACGTGCCCGAAT
TGTTAGCCGGGGCAACCCCGTTTCGTAGTG|CTGCAAACCGTCTGGGCTTTGTTGGCCTAT
GTGACTGTGTTAGGATAGAAGGGCCCGCGA|GAATCTCCATACCCCGTTTCGTAGTGTTAG
AGTGTTAACCCCGTTTCGTAGTGTTAGCCG|CTATAGTTAAGTGTACCTAGTATAAGCGCC
TACAGTTAGGCTTAGCCATCACTGCAAACC|TACACCAATATAGTGGTCTACACCCCAAAC
TACCCCGTTTCGTAGTGTTAGCCGGGGCAA|CAAAATTCCGGCCTTGCCTGTACTAGGTGC
GCTCCGTCAACGCTAGATCGTTCGCAGTTC|ATCCGGAGTCTGCCTCGTGTAAACTCATTT
TCTGTTGCGAGCTCCGTCAACGCTAGATCG|CAACCACTAGATCCGGAGTCTGCCTCGTGT
AGCTGCGGGAAATGACCACCCCGTTTCGTA|GTCCTGCAACATATAAGCAAAGACCCCCGA
GTAAGCGAGCTGCGGGAAATGACCACCCCG|CGTATAGGTCCTGCAACATATAAGCAAAGA
GTAGTGTTAGCCGGGGCAACACTAAGGCCG|TGCCCGAATCTACTAGAAAGTTCTTGAGGG
CGTCTGGGCTTTGTTGGCCTATAGTTAAGT|CCCCGTTTCGTAGTGTTAGCCGGGGCAACG
CTCGGGTTACACCAATATAGTGGTCTACAC|TAAGGCCGCGAGGTCAGTGACTGTGTTAGG
TCTGAAACAATATGTTATACATTAAGAAAA|CGATTGCACTGACCACCGTCGTCAGTCGTT
CCCGTTTCGTAGTGTTAGCCGGGGCAACAC|GGGCAACGTGCCCGAATCTACTAGAAAGTT
CCTCAAAGGCGCATATGATCGTGTTATTTA|GAGCTTGGGCGCTGAACTTAGCATTTTAGA
ACTGCAAACCGTCTGGGCTTTGTTGGCCTA|CACCCCAAACCCCGTTTCGTAGTGTTAGCC
TACTAGGTGCGACCCCGTTTCGTAGTGTTA|ATCCGTTAGTCTAGAGCTCGACTATGCTAT
GGCAACGTAGTGTTAGCCGGGGCAACCGCT|CTCCGTCAACGCTAGATCGTTCGCAGTTCG
GCCTCGGGTTACACCAATATAGTGGTCTAC|ACTAAGGCCGCGAGGTCAGTGACTGTGTTA
GGCAACCCCGTTTCGTAGTGTTAACCCCGT|TCTGGGCTTTGTTGGCCTATAGTTAAGTGT
GTTTCGTAGTGTTAGCCGGGGCAACTCGCT|TCCGGCCTTGCCTGTACTAGGTGCGACCCC
TTAGCCGGGGCAACCGCTATCCCAAATAAC|TAGATCGTTCGCAGTTCGTTAACACCCCGT
TAGTGTTAGCCGGGGCAACGGCGTGCATCC|GAAACTCCTCTGGAGAGCCCCGACGCGAGC
GGGCAACGTGCCCGAATCTACTAGAAAGTT|TTACCCCGTTTCGTAGTGTTAGCCGGGGCA
CACTAGATCCGGAGTCTGCCTCGTGTAAAC|TTTCGTAGTGTTAGCCGGGGCAACAGGCCT
GCGAGGTCAGTGACTGTGTTAGGATAGAAG|GCAAGACACGAATCTCCATACCCCGTTTCG
TGGCCTATAGTTAAGTGTACCTAGTATAAG|GTTAGCCGGGGCAACGACCTTTCACTCTCC
TTTCGTAGTGTTAGCACCCCGTTTCGTAGT|GGATCTACTGTCACTGTTCGGGCTATCCTT
GGGGCAACACTAAGGCCGCGAGGTCAGTGA|CTAGAAAGTTCTTGAGGGCAAGACACGAAT
CACCCCGTTTCGTAGTGTTAGCCGGGGCAA|TGTTCGGGCTATCCTTGGCTTGCTCTGTTG
GTGCGACCCCGTTTCGTAGTGTTAGCCGGG|TAGTCTAGAGCTCGACTATGCTATGGCCAG
CTCGAGCGGGTGACAGCAGGCTACGATTGC|ATCTGCTCAACAACCCCGTTTCACCCCGTT
CCCGTTTCGTAGTGTTAGCCGGGGCAACAC|GAGCTCGACTATGCTATGGCCAGACGCCTG
ACCCCGTTTCACCCCGTTTCGTAGTGTTAG|TTAGCCGGGGCAACACGGATCTACTGTCAC
GAGGGCAAGACACGAATCTCCATACCCCGT|GATGTGCTCGGAGCATTAGGAGCAAAATTC
GTAGTGTTAGCCGGGGCAACGACCTTTCAC|AAAGGTGTAGGTTAATGAGATATCCGAGAT
TCGTGTAAACTCATTTACAGTTAGGCTTAG|CAACAGGCCTCGGGTTACACCAATATAGTG
GGGCAAGACACGAATCTCCATACCCCGTTT|TGTGCTCGGAGCATTAGGAGCAAAATTCCG
TATCCGAGATTCACCCCGTTTCGTAGTGTT|TAGGTCTTTAGGCTCGTCAAGCCCGTTGCT
ACCACCGTCGTCAGTCGTTACCACACGCAT|AGTGTTAGCACCCCGTTTCGTAGTGTTAGC
CAGGCCTCGGGTTACACCAATATAGTGGTC|AACACTAAGGCCGCGAGGTCAGTGACTGTG
GTATAAGCGCCGAGATCCCCGAAACCCCGT|ACTCTCCACTTACGTAGCTAAGGCAACCCC
TCGGTCTCTGAAACAATATGTTATACATTA|AGGCTACGATTGCACTGACCACCGTCGTCA
CGTCAGTCGTTACCACACGCATTATAAACT|CACCCCGTTTCGTAGTGTTAGCCGGGGCAA
TGATCGTGTTATTTACATGACGCACTGCTC|ACTTAGCATTTTAGACGCCTACTGGCAATC
CGGGGCAACGTAGTGTTAGCCGGGGCAACC|GAGCTCCGTCAACGCTAGATCGTTCGCAGT
TAGTTAAGTGTACCTAGTATAAGCGCCGAG|GGGGCAACGACCTTTCACTCTCCACTTACG
GTAGTGTTAGCACCCCGTTTCGTAGTGTTA|CTACTGTCACTGTTCGGGCTATCCTTGGCT
TTAGCCATCACTGCAAACCGTCTGGGCTTT|AGTGGTCTACACCCCAAACCCCGTTTCGTA
CGGGGCAACACGGATCTACTGTCACTGTTC|TCGTAGTGTTAACCCCGTTTCGTAGTGTTA
GATTGCACTGACCACCGTCGTCAGTCGTTA|CCCGTTTCGTAGTGTTAGCACCCCGTTTCG
AGTGTTAGCCGGGGCAACACGGATCTACTG|AACCCCGTTTCGTAGTGTTAACCCCGTTTC
GCTTTGTTGGCCTATAGTTAAGTGTACCTA|TCGTAGTGTTAGCCGGGGCAACGACCTTTC
GTAGTGTTAGCCGGGGCAACGTGCCCGAAT|CCGTTGCTCTATATTACCCCGTTTCGTAGT
ACCAATATAGTGGTCTACACCCCAAACCCC|AGGTCAGTGACTGTGTTAGGATAGAAGGGC
CCGGGGCAACGCCGGGGCAACCACTAGATC|GCCGAGATCCCCGAAACCCCGTTTCGTAGT
GCAAACCGTCTGGGCTTTGTTGGCCTATAG|CCCAAACCCCGTTTCGTAGTGTTAGCCGGG
TAGTGGCCTCTCCTCAAAGGCGCATATGAT|TGTGCCACGATGAGCTTGGGCGCTGAACTT
GCCTCGTGTAAACTCATTTACAGTTAGGCT|GGGCAACAGGCCTCGGGTTACACCAATATA
TATGATCGTGTTATTTACATGACGCACTGC|GAACTTAGCATTTTAGACGCCTACTGGCAA
CACTGTTCGGGCTATCCTTGGCTTGCTCTG|TAGTGTTAGCCGGGGCAACGCCGGGGCAAC
GCAAGACACGAATCTCCATACCCCGTTTCG|TGCTCGGAGCATTAGGAGCAAAATTCCGGC
ATAGAAGGGCCCGCGAAAGGTGTAGGTTAA|CGTTTCGTAGTGTTAGCCGGGGCAACTCGC
TCGTGTTATTTACATGACGCACTGCTCGAG|TAGCATTTTAGACGCCTACTGGCAATCTGC
GGAGCAAAATTCCGGCCTTGCCTGTACTAG|CGTGCATCCTCGGATAATAAACCCATCCGT
CGCCGAGATCCCCGAAACCCCGTTTCGTAG|ACTTACGTAGCTAAGGCAACCCCGTTTCGT
TCGTAGTGTTAGCCGGGGCAACTCGCTCTC|GGCCTTGCCTGTACTAGGTGCGACCCCGTT
CCCGTTTCGTAGTGTTAGCCGGGGCAACAC|TAGCCGGGGCAACCCCGTTTCGTAGTGTTA
GGCCGCGAGGTCAGTGACTGTGTTAGGATA|GAGGGCAAGACACGAATCTCCATACCCCGT
GTTTCACCCCGTTTCGTAGTGTTAGCACCC|CGGGGCAACACGGATCTACTGTCACTGTTC
GGGCAACGTAGTGTTAGCCGGGGCAACCGC|GCTCCGTCAACGCTAGATCGTTCGCAGTTC
CGGGTTACACCAATATAGTGGTCTACACCC|AGGCCGCGAGGTCAGTGACTGTGTTAGGAT
GCTCGAGCGGGTGACAGCAGGCTACGATTG|AATCTGCTCAACAACCCCGTTTCACCCCGT
GGGGCAACGCCGGGGCAACCACTAGATCCG|CGAGATCCCCGAAACCCCGTTTCGTAGTGT
GCCTGTACTAGGTGCGACCCCGTTTCGTAG|AACCCATCCGTTAGTCTAGAGCTCGACTAT
CTCTTAGGTCTTTAGGCTCGTCAAGCCCGT|GTTTCGTAGTGTTAGCCGGGGCAACACCCG
TAGCCATCACTGCAAACCGTCTGGGCTTTG|GTGGTCTACACCCCAAACCCCGTTTCGTAG
AGATGTGCTCGGAGCATTAGGAGCAAAATT|GTGTTAGCCGGGGCAACGGCGTGCATCCTC
GCAACGCCGGGGCAACCACTAGATCCGGAG|GATCCCCGAAACCCCGTTTCGTAGTGTTAG
CTGAACTTAGCATTTTAGACGCCTACTGGC|AACCGCTATCCCAAATAACGTTAGAACACC
TGCACTGACCACCGTCGTCAGTCGTTACCA|GTTTCGTAGTGTTAGCACCCCGTTTCGTAG
AGCTCCGTCAACGCTAGATCGTTCGCAGTT|GATCCGGAGTCTGCCTCGTGTAAACTCATT
CGCATATGATCGTGTTATTTACATGACGCA|CGCTGAACTTAGCATTTTAGACGCCTACTG
TAGTGTTAGCCGGGGCAACCCCGTTTCGTA|TCACTGCAAACCGTCTGGGCTTTGTTGGCC
CCACTTACGTAGCTAAGGCAACCCCGTTTC|CCCCGTTTCGTAGTGTTAGCCGGGGCAACG
ACCCCGTTTCGTAGTGTTAGCCGGGGCAAC|GTTCGGGCTATCCTTGGCTTGCTCTGTTGC
CCTATAGTTAAGTGTACCTAGTATAAGCGC|AGCCGGGGCAACGACCTTTCACTCTCCACT
AGTGTACCTAGTATAAGCGCCGAGATCCCC|ACGACCTTTCACTCTCCACTTACGTAGCTA
CGTGTAAACTCATTTACAGTTAGGCTTAGC|AACAGGCCTCGGGTTACACCAATATAGTGG
CTACTGTCACTGTTCGGGCTATCCTTGGCT|CGTTTCGTAGTGTTAGCCGGGGCAACGCCG
TCTGCTCAACAACCCCGTTTCACCCCGTTT|GTTTCGTAGTGTTAGCCGGGGCAACACGGA
TAGATCGTTCGCAGTTCGTTAACACCCCGT|CTCGTGTAAACTCATTTACAGTTAGGCTTA
AAGGCCGCGAGGTCAGTGACTGTGTTAGGA|TTGAGGGCAAGACACGAATCTCCATACCCC
CGGGGCAACCGGGGCAACGTAGTGTTAGCC|CTCTGTTGCGAGCTCCGTCAACGCTAGATC
AAGGGCCCGCGAAAGGTGTAGGTTAATGAG|TCGTAGTGTTAGCCGGGGCAACTCGCTCTC
GTTCGCAGTTCGTTAACACCCCGTTTCGTA|TAAACTCATTTACAGTTAGGCTTAGCCATC
AATATAGTGGTCTACACCCCAAACCCCGTT|TCAGTGACTGTGTTAGGATAGAAGGGCCCG
GGGGCAACACCCGCAATGTAAGCGAGCTGC|CAGACGCCTGATAGGTTCGTATAGGTCCTG
GGCAACGCCGGGGCAACCACTAGATCCGGA|AGATCCCCGAAACCCCGTTTCGTAGTGTTA
AACCCCGTTTCGTAGTGTTAGCCGGGGCAA|AAGGGCCCGCGAAAGGTGTAGGTTAATGAG
CAACGCTAGATCGTTCGCAGTTCGTTAACA|GTCTGCCTCGTGTAAACTCATTTACAGTTA
TAGTGTTAGCCGGGGCAACGTGCCCGAATC|CGTTGCTCTATATTACCCCGTTTCGTAGTG
TTTGTTGGCCTATAGTTAAGTGTACCTAGT|GTAGTGTTAGCCGGGGCAACGACCTTTCAC
CAACGGCGTGCATCCTCGGATAATAAACCC|AGCCCCGACGCGAGCTTGGGGGCAATTCGT
TCTCTGAAACAATATGTTATACATTAAGAA|TACGATTGCACTGACCACCGTCGTCAGTCG
TTCCGGCCTTGCCTGTACTAGGTGCGACCC|TCGGATAATAAACCCATCCGTTAGTCTAGA
TCTCCATACCCCGTTTCGTAGTGTTAGCCG|TAGGAGCAAAATTCCGGCCTTGCCTGTACT
AGCCGGGGCAACACGGATCTACTGTCACTG|GTTTCGTAGTGTTAACCCCGTTTCGTAGTG
GCTAGATCGTTCGCAGTTCGTTAACACCCC|GCCTCGTGTAAACTCATTTACAGTTAGGCT
GTCAACGCTAGATCGTTCGCAGTTCGTTAA|GAGTCTGCCTCGTGTAAACTCATTTACAGT
TTTCGTAGTGTTAGCCGGGGCAACACGGAT|CGGGGCAACCCCGTTTCGTAGTGTTAACCC
TTTCGTAGTGTTAGCCGGGGCAACCGGGGC|GCTATCCTTGGCTTGCTCTGTTGCGAGCTC
CTTTCCCTGTGCCACGATGAGCTTGGGCGC|AACCGGGGCAACGTAGTGTTAGCCGGGGCA
AACCCCGTTTCGTAGTGTTAGCCGGGGCAA|TTAAGTGTACCTAGTATAAGCGCCGAGATC
AAATAGACGATAGTGGCCTCTCCTCAAAGG|AAACTTTCCCTGTGCCACGATGAGCTTGGG
GTGTTAGCCGGGGCAACTCGCTCTCTTAGG|TGCCTGTACTAGGTGCGACCCCGTTTCGTA
AGAAAGTTCTTGAGGGCAAGACACGAATCT|CCGGGGCAACAGATGTGCTCGGAGCATTAG
GGGCTTTGTTGGCCTATAGTTAAGTGTACC|TTTCGTAGTGTTAGCCGGGGCAACGACCTT
CCTTTCACTCTCCACTTACGTAGCTAAGGC|TCCGAGATTCACCCCGTTTCGTAGTGTTAG
AGTGTTAGCCGGGGCAACCCCGTTTCGTAG|CACTGCAAACCGTCTGGGCTTTGTTGGCCT
CTGCGGGAAATGACCACCCCGTTTCGTAGT|CCTGCAACATATAAGCAAAGACCCCCGAAA
GAAAGGTGTAGGTTAATGAGATATCCGAGA|AGCCGGGGCAACTCGCTCTCTTAGGTCTTT
TTAGCCGGGGCAACGCCGGGGCAACCACTA|AAGCGCCGAGATCCCCGAAACCCCGTTTCG
TCAAAGGCGCATATGATCGTGTTATTTACA|GCTTGGGCGCTGAACTTAGCATTTTAGACG
GCCTATAGTTAAGTGTACCTAGTATAAGCG|TAGCCGGGGCAACGACCTTTCACTCTCCAC
ATGTGCTCGGAGCATTAGGAGCAAAATTCC|GTTAGCCGGGGCAACGGCGTGCATCCTCGG
CTACACCCCAAACCCCGTTTCGTAGTGTTA|GTTAGGATAGAAGGGCCCGCGAAAGGTGTA
CGTTTCGTAGTGTTAGCCGGGGCAACACTA|GCAACGTGCCCGAATCTACTAGAAAGTTCT
CCCCAAACCCCGTTTCGTAGTGTTAGCCGG|GATAGAAGGGCCCGCGAAAGGTGTAGGTTA
CTAGTATAAGCGCCGAGATCCCCGAAACCC|TTCACTCTCCACTTACGTAGCTAAGGCAAC
CCCGTTGCTCTATATTACCCCGTTTCGTAG|ACCCGCAATGTAAGCGAGCTGCGGGAAATG
CGGGTGACAGCAGGCTACGATTGCACTGAC|TCAACAACCCCGTTTCACCCCGTTTCGTAG
TCTACACCCCAAACCCCGTTTCGTAGTGTT|TGTTAGGATAGAAGGGCCCGCGAAAGGTGT
TTTCGTAGTGTTAGCCGGGGCAACAGGCCT|CGTTTCGTAGTGTTAGCCGGGGCAACACTA
TGGGTAAATAGACGATAGTGGCCTCTCCTC|ATTATAAACTTTCCCTGTGCCACGATGAGC
CTAGAAAGTTCTTGAGGGCAAGACACGAAT|AGCCGGGGCAACAGATGTGCTCGGAGCATT
AACGCCGGGGCAACCACTAGATCCGGAGTC|TCCCCGAAACCCCGTTTCGTAGTGTTAGCC
AAACCCCGTTTCGTAGTGTTAGCCGGGGCA|GAAGGGCCCGCGAAAGGTGTAGGTTAATGA
AAGCGCCGAGATCCCCGAAACCCCGTTTCG|TCCACTTACGTAGCTAAGGCAACCCCGTTT
TACATTAAGAAAATGACCATAGTGGGTAAA|GTCGTCAGTCGTTACCACACGCATTATAAA
TTACATGACGCACTGCTCGAGCGGGTGACA|AGACGCCTACTGGCAATCTGCTCAACAACC
GGTGACAGCAGGCTACGATTGCACTGACCA|AACAACCCCGTTTCACCCCGTTTCGTAGTG
AGATATGGTCGGTCTCTGAAACAATATGTT|GTGACAGCAGGCTACGATTGCACTGACCAC
TATACATTAAGAAAATGACCATAGTGGGTA|CCGTCGTCAGTCGTTACCACACGCATTATA
TAGGTCTTTAGGCTCGTCAAGCCCGTTGCT|CGTAGTGTTAGCCGGGGCAACACCCGCAAT
TTAGCCGGGGCAACAGGCCTCGGGTTACAC|TGTTAGCCGGGGCAACACTAAGGCCGCGAG
ACGCACTGCTCGAGCGGGTGACAGCAGGCT|TACTGGCAATCTGCTCAACAACCCCGTTTC
ACTGTTCGGGCTATCCTTGGCTTGCTCTGT|AGTGTTAGCCGGGGCAACGCCGGGGCAACC
TGTTAGCCGGGGCAACACCCGCAATGTAAG|GCTATGGCCAGACGCCTGATAGGTTCGTAT
AACAATATGTTATACATTAAGAAAATGACC|GCACTGACCACCGTCGTCAGTCGTTACCAC
AGCAAAATTCCGGCCTTGCCTGTACTAGGT|TGCATCCTCGGATAATAAACCCATCCGTTA
AGATCCGGAGTCTGCCTCGTGTAAACTCAT|GTAGTGTTAGCCGGGGCAACAGGCCTCGGG
CGTTAGAACACCCCGTTTCGTAGTGTTAGC|TTTCGTAGTGTTAGCCGGGGCAACCCCGTT
CCGTTTCGTAGTGTTAGCCGGGGCAACACG|AGCCGGGGCAACCCCGTTTCGTAGTGTTAA
ACGTAGCTAAGGCAACCCCGTTTCGTAGTG|TTCGTAGTGTTAGCCGGGGCAACGTGCCCG
CGGGGCAACGGCGTGCATCCTCGGATAATA|TGGAGAGCCCCGACGCGAGCTTGGGGGCAA
CGCAGTTCGTTAACACCCCGTTTCGTAGTG|ACTCATTTACAGTTAGGCTTAGCCATCACT
CCGGGGCAACGTGCCCGAATCTACTAGAAA|ATATTACCCCGTTTCGTAGTGTTAGCCGGG
TCGTTCGCAGTTCGTTAACACCCCGTTTCG|TGTAAACTCATTTACAGTTAGGCTTAGCCA
AGGCTTAGCCATCACTGCAAACCGTCTGGG|ATATAGTGGTCTACACCCCAAACCCCGTTT
CGGGGCAACCGCTATCCCAAATAACGTTAG|CGTTCGCAGTTCGTTAACACCCCGTTTCGT
ACACCCCAAACCCCGTTTCGTAGTGTTAGC|TAGGATAGAAGGGCCCGCGAAAGGTGTAGG
ACTGGCAATCTGCTCAACAACCCCGTTTCA|AACACCCCGTTTCGTAGTGTTAGCCGGGGC
CCCCGAAACCCCGTTTCGTAGTGTTAGCCG|GCTAAGGCAACCCCGTTTCGTAGTGTTAGC
GCCGGGGCAACGTGCCCGAATCTACTAGAA|TATATTACCCCGTTTCGTAGTGTTAGCCGG
GAAACAATATGTTATACATTAAGAAAATGA|TTGCACTGACCACCGTCGTCAGTCGTTACC
GACCACCGTCGTCAGTCGTTACCACACGCA|TAGTGTTAGCACCCCGTTTCGTAGTGTTAG
TATAAACTTTCCCTGTGCCACGATGAGCTT|CGGGGCAACCGGGGCAACGTAGTGTTAGCC
CCGTTTCGTAGTGTTAGCCGGGGCAACTCG|ATTCCGGCCTTGCCTGTACTAGGTGCGACC
CAAACCGTCTGGGCTTTGTTGGCCTATAGT|CCAAACCCCGTTTCGTAGTGTTAGCCGGGG
CGTAGTGTTAGCCGGGGCAACCCCGTTTCG|CATCACTGCAAACCGTCTGGGCTTTGTTGG
AACGACCTTTCACTCTCCACTTACGTAGCT|AGATATCCGAGATTCACCCCGTTTCGTAGT
TGGCCTCTCCTCAAAGGCGCATATGATCGT|GCCACGATGAGCTTGGGCGCTGAACTTAGC
GTTCGTTAACACCCCGTTTCGTAGTGTTAG|ATTTACAGTTAGGCTTAGCCATCACTGCAA
GAGATATCCGAGATTCACCCCGTTTCGTAG|CTCTTAGGTCTTTAGGCTCGTCAAGCCCGT
GGCAACTCGCTCTCTTAGGTCTTTAGGCTC|GGTGCGACCCCGTTTCGTAGTGTTAGCCGG
TAAGTGTACCTAGTATAAGCGCCGAGATCC|CAACGACCTTTCACTCTCCACTTACGTAGC
ACACCCCGTTTCGTAGTGTTAGCCGGGGCA|TTAGGCTTAGCCATCACTGCAAACCGTCTG
TTATACATTAAGAAAATGACCATAGTGGGT|ACCGTCGTCAGTCGTTACCACACGCATTAT
TAGTGTTAGCCGGGGCAACTCGCTCTCTTA|CTTGCCTGTACTAGGTGCGACCCCGTTTCG
CGAGCGGGTGACAGCAGGCTACGATTGCAC|CTGCTCAACAACCCCGTTTCACCCCGTTTC
CCACCCCGTTTCGTAGTGTTAGCCGGGGCA|AGCAAAGACCCCCGAAACTCCTCTGGAGAG
CTGCTCAACAACCCCGTTTCACCCCGTTTC|TTTCGTAGTGTTAGCCGGGGCAACACGGAT
CCCGTTTCGTAGTGTTAGCCGGGGCAACAG|ACCCCGTTTCGTAGTGTTAGCCGGGGCAAC
TCTATATTACCCCGTTTCGTAGTGTTAGCC|TGTAAGCGAGCTGCGGGAAATGACCACCCC
ACCGTCGTCAGTCGTTACCACACGCATTAT|GTTAGCACCCCGTTTCGTAGTGTTAGCCGG
GCCGGGGCAACAGATGTGCTCGGAGCATTA|CCCGTTTCGTAGTGTTAGCCGGGGCAACGG
GGCCTATAGTTAAGTGTACCTAGTATAAGC|TTAGCCGGGGCAACGACCTTTCACTCTCCA
TCACTGTTCGGGCTATCCTTGGCTTGCTCT|GTAGTGTTAGCCGGGGCAACGCCGGGGCAA
GTCTACACCCCAAACCCCGTTTCGTAGTGT|GTGTTAGGATAGAAGGGCCCGCGAAAGGTG
GGGGCAACAGATGTGCTCGGAGCATTAGGA|GTTTCGTAGTGTTAGCCGGGGCAACGGCGT
AGCCGGGGCAACAGGCCTCGGGTTACACCA|TTAGCCGGGGCAACACTAAGGCCGCGAGGT
GGGGCAACCACTAGATCCGGAGTCTGCCTC|AAACCCCGTTTCGTAGTGTTAGCCGGGGCA
TGTTAGCACCCCGTTTCGTAGTGTTAGCCG|TGTCACTGTTCGGGCTATCCTTGGCTTGCT
TGTTAGCCGGGGCAACACTAAGGCCGCGAG|CGAATCTACTAGAAAGTTCTTGAGGGCAAG
CGTAGTGTTAGCCGGGGCAACAGGCCTCGG|TTCGTAGTGTTAGCCGGGGCAACACTAAGG
GCAACCGCTATCCCAAATAACGTTAGAACA|CGCAGTTCGTTAACACCCCGTTTCGTAGTG
ATTAAGAAAATGACCATAGTGGGTAAATAG|GTCAGTCGTTACCACACGCATTATAAACTT
GCCGGGGCAACTCGCTCTCTTAGGTCTTTA|TACTAGGTGCGACCCCGTTTCGTAGTGTTA
AGCCGGGGCAACGTGCCCGAATCTACTAGA|CTATATTACCCCGTTTCGTAGTGTTAGCCG
ACCCCAAACCCCGTTTCGTAGTGTTAGCCG|GGATAGAAGGGCCCGCGAAAGGTGTAGGTT
ACCGGGGCAACGTAGTGTTAGCCGGGGCAA|GCGAGCTCCGTCAACGCTAGATCGTTCGCA
GGGCAACGCCGGGGCAACCACTAGATCCGG|GAGATCCCCGAAACCCCGTTTCGTAGTGTT
TGCGAGCTCCGTCAACGCTAGATCGTTCGC|ACTAGATCCGGAGTCTGCCTCGTGTAAACT
TAGCCGGGGCAACACGGATCTACTGTCACT|CGTTTCGTAGTGTTAACCCCGTTTCGTAGT
CCCGTTTCACCCCGTTTCGTAGTGTTAGCA|AGCCGGGGCAACACGGATCTACTGTCACTG
ACCACCCCGTTTCGTAGTGTTAGCCGGGGC|AAGCAAAGACCCCCGAAACTCCTCTGGAGA
AGGTAGATATGGTCGGTCTCTGAAACAATA|GCGGGTGACAGCAGGCTACGATTGCACTGA
GGGCTATCCTTGGCTTGCTCTGTTGCGAGC|GCCGGGGCAACGCCGGGGCAACCACTAGAT
AACCGCTATCCCAAATAACGTTAGAACACC|CAGTTCGTTAACACCCCGTTTCGTAGTGTT
GTCGTCAGTCGTTACCACACGCATTATAAA|AGCACCCCGTTTCGTAGTGTTAGCCGGGGC
GACGATAGTGGCCTCTCCTCAAAGGCGCAT|TTCCCTGTGCCACGATGAGCTTGGGCGCTG
GTTTCGTAGTGTTAGCCGGGGCAACCCCGT|TAGCCATCACTGCAAACCGTCTGGGCTTTG
ATTTTAGACGCCTACTGGCAATCTGCTCAA|CAAATAACGTTAGAACACCCCGTTTCGTAG
GTAGTGTTAGCCGGGGCAACCGCTATCCCA|CAACGCTAGATCGTTCGCAGTTCGTTAACA
GCGAAAGGTGTAGGTTAATGAGATATCCGA|TTAGCCGGGGCAACTCGCTCTCTTAGGTCT
GTGTTAGCCGGGGCAACACTAAGGCCGCGA|CCGAATCTACTAGAAAGTTCTTGAGGGCAA
TAGATATGGTCGGTCTCTGAAACAATATGT|GGTGACAGCAGGCTACGATTGCACTGACCA
GAGATCCCCGAAACCCCGTTTCGTAGTGTT|ACGTAGCTAAGGCAACCCCGTTTCGTAGTG
TTACCCCGTTTCGTAGTGTTAGCCGGGGCA|CGAGCTGCGGGAAATGACCACCCCGTTTCG
ACCCCGTTTCGTAGTGTTAGCCGGGGCAAC|AAAATTCCGGCCTTGCCTGTACTAGGTGCG
ATTACCCCGTTTCGTAGTGTTAGCCGGGGC|GCGAGCTGCGGGAAATGACCACCCCGTTTC
CTGCAAACCGTCTGGGCTTTGTTGGCCTAT|ACCCCAAACCCCGTTTCGTAGTGTTAGCCG
GGCGCATATGATCGTGTTATTTACATGACG|GGCGCTGAACTTAGCATTTTAGACGCCTAC
CTTGCTCTGTTGCGAGCTCCGTCAACGCTA|CGGGGCAACCACTAGATCCGGAGTCTGCCT
GTTTCGTAGTGTTAGCACCCCGTTTCGTAG|CGGATCTACTGTCACTGTTCGGGCTATCCT
TTACGTAGCTAAGGCAACCCCGTTTCGTAG|GTTTCGTAGTGTTAGCCGGGGCAACGTGCC
GGCTTAGCCATCACTGCAAACCGTCTGGGC|TATAGTGGTCTACACCCCAAACCCCGTTTC
CCCCGTTTCGTAGTGTTAGCCGGGGCAACA|AACCCCGTTTCGTAGTGTTAGCCGGGGCAA
TTAGCCGGGGCAACGGCGTGCATCCTCGGA|TCCTCTGGAGAGCCCCGACGCGAGCTTGGG
GGGAAATGACCACCCCGTTTCGTAGTGTTA|CAACATATAAGCAAAGACCCCCGAAACTCC
TGGTCTACACCCCAAACCCCGTTTCGTAGT|CTGTGTTAGGATAGAAGGGCCCGCGAAAGG
TTAGCACCCCGTTTCGTAGTGTTAGCCGGG|TCACTGTTCGGGCTATCCTTGGCTTGCTCT
GAGCTCCGTCAACGCTAGATCGTTCGCAGT|AGATCCGGAGTCTGCCTCGTGTAAACTCAT
GCCGGGGCAACGCCGGGGCAACCACTAGAT|CGCCGAGATCCCCGAAACCCCGTTTCGTAG
TTTACATGACGCACTGCTCGAGCGGGTGAC|TAGACGCCTACTGGCAATCTGCTCAACAAC
TTTCGTAGTGTTAGCCGGGGCAACAGATGT|GGGAAATGACCACCCCGTTTCGTAGTGTTA
GGCAATCTGCTCAACAACCCCGTTTCACCC|ACCCCGTTTCGTAGTGTTAGCCGGGGCAAC
CCGAATCTACTAGAAAGTTCTTGAGGGCAA|CGTAGTGTTAGCCGGGGCAACAGATGTGCT
AATCTGCTCAACAACCCCGTTTCACCCCGT|CCGTTTCGTAGTGTTAGCCGGGGCAACACG
GACTGTGTTAGGATAGAAGGGCCCGCGAAA|ATCTCCATACCCCGTTTCGTAGTGTTAGCC
CTTAGCCATCACTGCAAACCGTCTGGGCTT|TAGTGGTCTACACCCCAAACCCCGTTTCGT
GGATCTACTGTCACTGTTCGGGCTATCCTT|ACCCCGTTTCGTAGTGTTAGCCGGGGCAAC
TAACACCCCGTTTCGTAGTGTTAGCCGGGG|AGTTAGGCTTAGCCATCACTGCAAACCGTC
AGATCGTTCGCAGTTCGTTAACACCCCGTT|TCGTGTAAACTCATTTACAGTTAGGCTTAG
TTACACCAATATAGTGGTCTACACCCCAAA|CGCGAGGTCAGTGACTGTGTTAGGATAGAA
CGTTACCACACGCATTATAAACTTTCCCTG|TTTCGTAGTGTTAGCCGGGGCAACCGGGGC
GCCGGGGCAACCGGGGCAACGTAGTGTTAG|TGCTCTGTTGCGAGCTCCGTCAACGCTAGA
TTCGTAGTGTTAGCCGGGGCAACCCCGTTT|GCCATCACTGCAAACCGTCTGGGCTTTGTT
TTAGCCGGGGCAACAGATGTGCTCGGAGCA|CACCCCGTTTCGTAGTGTTAGCCGGGGCAA
TGCGGGAAATGACCACCCCGTTTCGTAGTG|CTGCAACATATAAGCAAAGACCCCCGAAAC
TCAACGCTAGATCGTTCGCAGTTCGTTAAC|AGTCTGCCTCGTGTAAACTCATTTACAGTT
TGCTCAACAACCCCGTTTCACCCCGTTTCG|TTCGTAGTGTTAGCCGGGGCAACACGGATC
ATATAGTGGTCTACACCCCAAACCCCGTTT|CAGTGACTGTGTTAGGATAGAAGGGCCCGC
GGCAACACTAAGGCCGCGAGGTCAGTGACT|AGAAAGTTCTTGAGGGCAAGACACGAATCT
GGCTACGATTGCACTGACCACCGTCGTCAG|TTTCACCCCGTTTCGTAGTGTTAGCACCCC
TTAGCCGGGGCAACACGGATCTACTGTCAC|CCGTTTCGTAGTGTTAACCCCGTTTCGTAG
AGGCCTCGGGTTACACCAATATAGTGGTCT|ACACTAAGGCCGCGAGGTCAGTGACTGTGT
CCGTTTCGTAGTGTTAGCCGGGGCAACGCC|GTGTACCTAGTATAAGCGCCGAGATCCCCG
TGGCTTGCTCTGTTGCGAGCTCCGTCAACG|CGCCGGGGCAACCACTAGATCCGGAGTCTG
AAGTTCTTGAGGGCAAGACACGAATCTCCA|GGGCAACAGATGTGCTCGGAGCATTAGGAG
GTGTTAGGATAGAAGGGCCCGCGAAAGGTG|CCATACCCCGTTTCGTAGTGTTAGCCGGGG
TACCACACGCATTATAAACTTTCCCTGTGC|CGTAGTGTTAGCCGGGGCAACCGGGGCAAC
GTTACCACACGCATTATAAACTTTCCCTGT|TTCGTAGTGTTAGCCGGGGCAACCGGGGCA
TGTAGGTTAATGAGATATCCGAGATTCACC|GGCAACTCGCTCTCTTAGGTCTTTAGGCTC
GTCAGTGACTGTGTTAGGATAGAAGGGCCC|ACACGAATCTCCATACCCCGTTTCGTAGTG
AGGCTCGTCAAGCCCGTTGCTCTATATTAC|AGCCGGGGCAACACCCGCAATGTAAGCGAG
CCCGCAATGTAAGCGAGCTGCGGGAAATGA|GATAGGTTCGTATAGGTCCTGCAACATATA
TTGCTCTGTTGCGAGCTCCGTCAACGCTAG|GGGGCAACCACTAGATCCGGAGTCTGCCTC
CGCGAGGTCAGTGACTGTGTTAGGATAGAA|GGCAAGACACGAATCTCCATACCCCGTTTC
CCGGGGCAACAGATGTGCTCGGAGCATTAG|CCGTTTCGTAGTGTTAGCCGGGGCAACGGC
CCATAGTGGGTAAATAGACGATAGTGGCCT|ACACGCATTATAAACTTTCCCTGTGCCACG
TTCGTAGTGTTAGCCGGGGCAACACTAAGG|ACGTGCCCGAATCTACTAGAAAGTTCTTGA
CCGTTTCGTAGTGTTAGCCGGGGCAACAGG|CCCCGTTTCGTAGTGTTAGCCGGGGCAACA
ATCGTGTTATTTACATGACGCACTGCTCGA|TTAGCATTTTAGACGCCTACTGGCAATCTG
CGCCGGGGCAACCACTAGATCCGGAGTCTG|CCCGAAACCCCGTTTCGTAGTGTTAGCCGG
GTCAGTCGTTACCACACGCATTATAAACTT|ACCCCGTTTCGTAGTGTTAGCCGGGGCAAC
CCGGGGCAACTCGCTCTCTTAGGTCTTTAG|ACTAGGTGCGACCCCGTTTCGTAGTGTTAG
TAGCCGGGGCAACAGATGTGCTCGGAGCAT|ACCCCGTTTCGTAGTGTTAGCCGGGGCAAC
AACCGTCTGGGCTTTGTTGGCCTATAGTTA|AAACCCCGTTTCGTAGTGTTAGCCGGGGCA
TCGTAGTGTTAGCCGGGGCAACCGGGGCAA|TATCCTTGGCTTGCTCTGTTGCGAGCTCCG
GTTAACACCCCGTTTCGTAGTGTTAGCCGG|ACAGTTAGGCTTAGCCATCACTGCAAACCG
CTGTGTTAGGATAGAAGGGCCCGCGAAAGG|CTCCATACCCCGTTTCGTAGTGTTAGCCGG
ACAGCAGGCTACGATTGCACTGACCACCGT|ACCCCGTTTCACCCCGTTTCGTAGTGTTAG
CGCTGAACTTAGCATTTTAGACGCCTACTG|GCAACCGCTATCCCAAATAACGTTAGAACA
GTGGGTAAATAGACGATAGTGGCCTCTCCT|CATTATAAACTTTCCCTGTGCCACGATGAG
GACAGCAGGCTACGATTGCACTGACCACCG|AACCCCGTTTCACCCCGTTTCGTAGTGTTA
CGTTTCGTAGTGTTAGCCGGGGCAACGCCG|TGTACCTAGTATAAGCGCCGAGATCCCCGA
CCGGGGCAACAGGCCTCGGGTTACACCAAT|AGCCGGGGCAACACTAAGGCCGCGAGGTCA
GCCGGGGCAACGGCGTGCATCCTCGGATAA|TCTGGAGAGCCCCGACGCGAGCTTGGGGGC
AGGCTACGATTGCACTGACCACCGTCGTCA|GTTTCACCCCGTTTCGTAGTGTTAGCACCC
AGATATCCGAGATTCACCCCGTTTCGTAGT|TCTTAGGTCTTTAGGCTCGTCAAGCCCGTT
GCAATCTGCTCAACAACCCCGTTTCACCCC|CCCCGTTTCGTAGTGTTAGCCGGGGCAACA
TGCGACCCCGTTTCGTAGTGTTAGCCGGGG|AGTCTAGAGCTCGACTATGCTATGGCCAGA
ACTTAGCATTTTAGACGCCTACTGGCAATC|GCTATCCCAAATAACGTTAGAACACCCCGT
CTGACCACCGTCGTCAGTCGTTACCACACG|CGTAGTGTTAGCACCCCGTTTCGTAGTGTT
CCGTTTCGTAGTGTTAGCCGGGGCAACGGC|AGACCCCCGAAACTCCTCTGGAGAGCCCCG
AACAGGCCTCGGGTTACACCAATATAGTGG|GCAACACTAAGGCCGCGAGGTCAGTGACTG
AGCCGGGGCAACGACCTTTCACTCTCCACT|AGGTTAATGAGATATCCGAGATTCACCCCG
TAACCCCGTTTCGTAGTGTTAGCCGGGGCA|GTTAAGTGTACCTAGTATAAGCGCCGAGAT
GGGCAACCGCTATCCCAAATAACGTTAGAA|TTCGCAGTTCGTTAACACCCCGTTTCGTAG
GGGCAACTCGCTCTCTTAGGTCTTTAGGCT|AGGTGCGACCCCGTTTCGTAGTGTTAGCCG
GCAATGTAAGCGAGCTGCGGGAAATGACCA|AGGTTCGTATAGGTCCTGCAACATATAAGC
GTAGTGTTAGCCGGGGCAACTCGCTCTCTT|CCTTGCCTGTACTAGGTGCGACCCCGTTTC
ATAAACTTTCCCTGTGCCACGATGAGCTTG|GGGGCAACCGGGGCAACGTAGTGTTAGCCG
TCGTAGTGTTAGCCGGGGCAACGTGCCCGA|GCCCGTTGCTCTATATTACCCCGTTTCGTA
GCCTTGCCTGTACTAGGTGCGACCCCGTTT|TAATAAACCCATCCGTTAGTCTAGAGCTCG
TGTTAGCCGGGGCAACTCGCTCTCTTAGGT|GCCTGTACTAGGTGCGACCCCGTTTCGTAG
CACCCCGTTTCGTAGTGTTAGCCGGGGCAA|GCTCGTCAAGCCCGTTGCTCTATATTACCC
TAGGCTTAGCCATCACTGCAAACCGTCTGG|AATATAGTGGTCTACACCCCAAACCCCGTT
TCCGAGATTCACCCCGTTTCGTAGTGTTAG|GGTCTTTAGGCTCGTCAAGCCCGTTGCTCT
CCGGAGTCTGCCTCGTGTAAACTCATTTAC|TGTTAGCCGGGGCAACAGGCCTCGGGTTAC
ATGTTATACATTAAGAAAATGACCATAGTG|ACCACCGTCGTCAGTCGTTACCACACGCAT
ACCTTTCACTCTCCACTTACGTAGCTAAGG|ATCCGAGATTCACCCCGTTTCGTAGTGTTA
TGCTCGAGCGGGTGACAGCAGGCTACGATT|CAATCTGCTCAACAACCCCGTTTCACCCCG
GTTAGGCTTAGCCATCACTGCAAACCGTCT|CCAATATAGTGGTCTACACCCCAAACCCCG
ATATTACCCCGTTTCGTAGTGTTAGCCGGG|AAGCGAGCTGCGGGAAATGACCACCCCGTT
GTTATTTACATGACGCACTGCTCGAGCGGG|ATTTTAGACGCCTACTGGCAATCTGCTCAA
TCTGCCTCGTGTAAACTCATTTACAGTTAG|CCGGGGCAACAGGCCTCGGGTTACACCAAT
CTCCACTTACGTAGCTAAGGCAACCCCGTT|CACCCCGTTTCGTAGTGTTAGCCGGGGCAA
TGACGCACTGCTCGAGCGGGTGACAGCAGG|CCTACTGGCAATCTGCTCAACAACCCCGTT
TACTAGAAAGTTCTTGAGGGCAAGACACGA|TTAGCCGGGGCAACAGATGTGCTCGGAGCA
CTTTCACTCTCCACTTACGTAGCTAAGGCA|CCGAGATTCACCCCGTTTCGTAGTGTTAGC
ACGGATCTACTGTCACTGTTCGGGCTATCC|TAACCCCGTTTCGTAGTGTTAGCCGGGGCA
GGGGCAACCGCTATCCCAAATAACGTTAGA|GTTCGCAGTTCGTTAACACCCCGTTTCGTA
CATACCCCGTTTCGTAGTGTTAGCCGGGGC|AGCAAAATTCCGGCCTTGCCTGTACTAGGT
CAACTCGCTCTCTTAGGTCTTTAGGCTCGT|TGCGACCCCGTTTCGTAGTGTTAGCCGGGG
GTTTCGTAGTGTTAGCCGGGGCAACACTAA|CAACGTGCCCGAATCTACTAGAAAGTTCTT
TGTGCTCGGAGCATTAGGAGCAAAATTCCG|TTAGCCGGGGCAACGGCGTGCATCCTCGGA
CCGAAACCCCGTTTCGTAGTGTTAGCCGGG|TAAGGCAACCCCGTTTCGTAGTGTTAGCCG
GAAAGTTCTTGAGGGCAAGACACGAATCTC|CGGGGCAACAGATGTGCTCGGAGCATTAGG
TTACCACACGCATTATAAACTTTCCCTGTG|TCGTAGTGTTAGCCGGGGCAACCGGGGCAA
CCGTTGCTCTATATTACCCCGTTTCGTAGT|CCCGCAATGTAAGCGAGCTGCGGGAAATGA
TTCGTAGTGTTAGCCGGGGCAACGGCGTGC|CCCCGAAACTCCTCTGGAGAGCCCCGACGC
AGCCGGGGCAACCCCGTTTCGTAGTGTTAA|AAACCGTCTGGGCTTTGTTGGCCTATAGTT
AAAGGCGCATATGATCGTGTTATTTACATG|TTGGGCGCTGAACTTAGCATTTTAGACGCC
AAACTTTCCCTGTGCCACGATGAGCTTGGG|GGCAACCGGGGCAACGTAGTGTTAGCCGGG
TCGTTAACACCCCGTTTCGTAGTGTTAGCC|TTACAGTTAGGCTTAGCCATCACTGCAAAC
GGAAATGACCACCCCGTTTCGTAGTGTTAG|AACATATAAGCAAAGACCCCCGAAACTCCT
GTAGCTAAGGCAACCCCGTTTCGTAGTGTT|CGTAGTGTTAGCCGGGGCAACGTGCCCGAA
GTAGTGTTAGCCGGGGCAACAGGCCTCGGG|TCGTAGTGTTAGCCGGGGCAACACTAAGGC
AGGTTAATGAGATATCCGAGATTCACCCCG|AACTCGCTCTCTTAGGTCTTTAGGCTCGTC
ATCACTGCAAACCGTCTGGGCTTTGTTGGC|CTACACCCCAAACCCCGTTTCGTAGTGTTA
CTCTGAAACAATATGTTATACATTAAGAAA|ACGATTGCACTGACCACCGTCGTCAGTCGT
TAGGCTCGTCAAGCCCGTTGCTCTATATTA|TAGCCGGGGCAACACCCGCAATGTAAGCGA
GTTTCGTAGTGTTAGCCGGGGCAACACGGA|CCGGGGCAACCCCGTTTCGTAGTGTTAACC
CTCTGTTGCGAGCTCCGTCAACGCTAGATC|GCAACCACTAGATCCGGAGTCTGCCTCGTG
GCGACCCCGTTTCGTAGTGTTAGCCGGGGC|GTCTAGAGCTCGACTATGCTATGGCCAGAC
TTCGCAGTTCGTTAACACCCCGTTTCGTAG|AAACTCATTTACAGTTAGGCTTAGCCATCA
CCGTCTGGGCTTTGTTGGCCTATAGTTAAG|ACCCCGTTTCGTAGTGTTAGCCGGGGCAAC
TGCCCGAATCTACTAGAAAGTTCTTGAGGG|TTTCGTAGTGTTAGCCGGGGCAACAGATGT
TTACAGTTAGGCTTAGCCATCACTGCAAAC|TTACACCAATATAGTGGTCTACACCCCAAA
CCCCGTTTCGTAGTGTTAGCCGGGGCAACC|GGCTTAGCCATCACTGCAAACCGTCTGGGC
GACCATAGTGGGTAAATAGACGATAGTGGC|CCACACGCATTATAAACTTTCCCTGTGCCA
GTGTTAACCCCGTTTCGTAGTGTTAGCCGG|TATAGTTAAGTGTACCTAGTATAAGCGCCG
TCTGGGCTTTGTTGGCCTATAGTTAAGTGT|CCGTTTCGTAGTGTTAGCCGGGGCAACGAC
GTAGGTTAATGAGATATCCGAGATTCACCC|GCAACTCGCTCTCTTAGGTCTTTAGGCTCG
CGTCAACGCTAGATCGTTCGCAGTTCGTTA|GGAGTCTGCCTCGTGTAAACTCATTTACAG
CCTTGGCTTGCTCTGTTGCGAGCTCCGTCA|CAACGCCGGGGCAACCACTAGATCCGGAGT
TCTACTGTCACTGTTCGGGCTATCCTTGGC|CCGTTTCGTAGTGTTAGCCGGGGCAACGCC
GATCGTGTTATTTACATGACGCACTGCTCG|CTTAGCATTTTAGACGCCTACTGGCAATCT
ACGCATTATAAACTTTCCCTGTGCCACGAT|GTTAGCCGGGGCAACCGGGGCAACGTAGTG
GGTAGATATGGTCGGTCTCTGAAACAATAT|CGGGTGACAGCAGGCTACGATTGCACTGAC
CCCCGTTTCGTAGTGTTAGCCGGGGCAACA|AGAGCTCGACTATGCTATGGCCAGACGCCT
ACCCCGTTTCGTAGTGTTAGCCGGGGCAAC|AGGCTTAGCCATCACTGCAAACCGTCTGGG
TACATGACGCACTGCTCGAGCGGGTGACAG|GACGCCTACTGGCAATCTGCTCAACAACCC
CGTGCCCGAATCTACTAGAAAGTTCTTGAG|CGTTTCGTAGTGTTAGCCGGGGCAACAGAT
AACCGGGGCAACGTAGTGTTAGCCGGGGCA|TGCGAGCTCCGTCAACGCTAGATCGTTCGC
CTAGATCGTTCGCAGTTCGTTAACACCCCG|CCTCGTGTAAACTCATTTACAGTTAGGCTT
AGAAGGGCCCGCGAAAGGTGTAGGTTAATG|TTTCGTAGTGTTAGCCGGGGCAACTCGCTC
GCAACACCCGCAATGTAAGCGAGCTGCGGG|ACGCCTGATAGGTTCGTATAGGTCCTGCAA
CGAAACCCCGTTTCGTAGTGTTAGCCGGGG|AAGGCAACCCCGTTTCGTAGTGTTAGCCGG
CAATCTGCTCAACAACCCCGTTTCACCCCG|CCCGTTTCGTAGTGTTAGCCGGGGCAACAC
AGCCGGGGCAACCGGGGCAACGTAGTGTTA|TTGCTCTGTTGCGAGCTCCGTCAACGCTAG
CACTGACCACCGTCGTCAGTCGTTACCACA|TTCGTAGTGTTAGCACCCCGTTTCGTAGTG
TCTTGAGGGCAAGACACGAATCTCCATACC|AACAGATGTGCTCGGAGCATTAGGAGCAAA
ATTCAATCAAGGTAGATATGGTCGGTCTCT|ACTGCTCGAGCGGGTGACAGCAGGCTACGA
GCGGGTGACAGCAGGCTACGATTGCACTGA|CTCAACAACCCCGTTTCACCCCGTTTCGTA
GGTCGGTCTCTGAAACAATATGTTATACAT|GCAGGCTACGATTGCACTGACCACCGTCGT
AGTGTTAGCCGGGGCAACGACCTTTCACTC|AGGTGTAGGTTAATGAGATATCCGAGATTC
ACTTACGTAGCTAAGGCAACCCCGTTTCGT|CCGTTTCGTAGTGTTAGCCGGGGCAACGTG
TCCGGAGTCTGCCTCGTGTAAACTCATTTA|GTGTTAGCCGGGGCAACAGGCCTCGGGTTA
TTGTTGGCCTATAGTTAAGTGTACCTAGTA|TAGTGTTAGCCGGGGCAACGACCTTTCACT
ACCCCGTTTCGTAGTGTTAGCCGGGGCAAC|TAGAGCTCGACTATGCTATGGCCAGACGCC
GTTACACCAATATAGTGGTCTACACCCCAA|CCGCGAGGTCAGTGACTGTGTTAGGATAGA
TCACCCCGTTTCGTAGTGTTAGCACCCCGT|GGCAACACGGATCTACTGTCACTGTTCGGG
GATCCGGAGTCTGCCTCGTGTAAACTCATT|TAGTGTTAGCCGGGGCAACAGGCCTCGGGT
AATAGACGATAGTGGCCTCTCCTCAAAGGC|AACTTTCCCTGTGCCACGATGAGCTTGGGC
AGAACACCCCGTTTCGTAGTGTTAGCCGGG|GTAGTGTTAGCCGGGGCAACCCCGTTTCGT
GCAACGTAGTGTTAGCCGGGGCAACCGCTA|TCCGTCAACGCTAGATCGTTCGCAGTTCGT
TGTAAACTCATTTACAGTTAGGCTTAGCCA|CAGGCCTCGGGTTACACCAATATAGTGGTC
ATTCACCCCGTTTCGTAGTGTTAGCCGGGG|TAGGCTCGTCAAGCCCGTTGCTCTATATTA
TTTCCCTGTGCCACGATGAGCTTGGGCGCT|ACCGGGGCAACGTAGTGTTAGCCGGGGCAA
CAATATGTTATACATTAAGAAAATGACCAT|ACTGACCACCGTCGTCAGTCGTTACCACAC
TTGCACTGACCACCGTCGTCAGTCGTTACC|CGTTTCGTAGTGTTAGCACCCCGTTTCGTA
TAGCCGGGGCAACGTGCCCGAATCTACTAG|TCTATATTACCCCGTTTCGTAGTGTTAGCC
TTAGCCGGGGCAACCCCGTTTCGTAGTGTT|GCAAACCGTCTGGGCTTTGTTGGCCTATAG
CAACAACCCCGTTTCACCCCGTTTCGTAGT|TAGTGTTAGCCGGGGCAACACGGATCTACT
GTTCTTGAGGGCAAGACACGAATCTCCATA|GCAACAGATGTGCTCGGAGCATTAGGAGCA
TCACTGCAAACCGTCTGGGCTTTGTTGGCC|TACACCCCAAACCCCGTTTCGTAGTGTTAG
ACGTTAGAACACCCCGTTTCGTAGTGTTAG|GTTTCGTAGTGTTAGCCGGGGCAACCCCGT
CCTCTCCTCAAAGGCGCATATGATCGTGTT|ACGATGAGCTTGGGCGCTGAACTTAGCATT
AACACCCGCAATGTAAGCGAGCTGCGGGAA|GCCTGATAGGTTCGTATAGGTCCTGCAACA
TGCTCTATATTACCCCGTTTCGTAGTGTTA|CAATGTAAGCGAGCTGCGGGAAATGACCAC
CCGGGGCAACGGCGTGCATCCTCGGATAAT|CTGGAGAGCCCCGACGCGAGCTTGGGGGCA
CCCAAATAACGTTAGAACACCCCGTTTCGT|AACACCCCGTTTCGTAGTGTTAGCCGGGGC
ACTGCTCGAGCGGGTGACAGCAGGCTACGA|GGCAATCTGCTCAACAACCCCGTTTCACCC
CAGTTCGTTAACACCCCGTTTCGTAGTGTT|TCATTTACAGTTAGGCTTAGCCATCACTGC
CATTTTAGACGCCTACTGGCAATCTGCTCA|CCAAATAACGTTAGAACACCCCGTTTCGTA
CTTAGGTCTTTAGGCTCGTCAAGCCCGTTG|TTCGTAGTGTTAGCCGGGGCAACACCCGCA
TCCGTCAACGCTAGATCGTTCGCAGTTCGT|CCGGAGTCTGCCTCGTGTAAACTCATTTAC
TTCGTAGTGTTAGCACCCCGTTTCGTAGTG|GATCTACTGTCACTGTTCGGGCTATCCTTG
CACGAATCTCCATACCCCGTTTCGTAGTGT|GAGCATTAGGAGCAAAATTCCGGCCTTGCC
CCGAGATTCACCCCGTTTCGTAGTGTTAGC|GTCTTTAGGCTCGTCAAGCCCGTTGCTCTA
CAACCGGGGCAACGTAGTGTTAGCCGGGGC|TTGCGAGCTCCGTCAACGCTAGATCGTTCG
CACTAAGGCCGCGAGGTCAGTGACTGTGTT|GTTCTTGAGGGCAAGACACGAATCTCCATA
AGGCCGCGAGGTCAGTGACTGTGTTAGGAT|TGAGGGCAAGACACGAATCTCCATACCCCG
GGGGCAACCCCGTTTCGTAGTGTTAACCCC|CGTCTGGGCTTTGTTGGCCTATAGTTAAGT
CACCCCGTTTCGTAGTGTTAGCACCCCGTT|GCAACACGGATCTACTGTCACTGTTCGGGC
GTTAGAACACCCCGTTTCGTAGTGTTAGCC|TTCGTAGTGTTAGCCGGGGCAACCCCGTTT
AACCCCGTTTCGTAGTGTTAGCCGGGGCAA|GCAACCCCGTTTCGTAGTGTTAGCCGGGGC
ACACCAATATAGTGGTCTACACCCCAAACC|CGAGGTCAGTGACTGTGTTAGGATAGAAGG
CGGGGCAACGCCGGGGCAACCACTAGATCC|CCGAGATCCCCGAAACCCCGTTTCGTAGTG
AAGAAAATGACCATAGTGGGTAAATAGACG|AGTCGTTACCACACGCATTATAAACTTTCC
TACTGGCAATCTGCTCAACAACCCCGTTTC|GAACACCCCGTTTCGTAGTGTTAGCCGGGG
ATTTACATGACGCACTGCTCGAGCGGGTGA|TTAGACGCCTACTGGCAATCTGCTCAACAA
TTTCGTAGTGTTAGCCGGGGCAACGGCGTG|CCCCCGAAACTCCTCTGGAGAGCCCCGACG
AATGTAAGCGAGCTGCGGGAAATGACCACC|GTTCGTATAGGTCCTGCAACATATAAGCAA
ATGAGCTTGGGCGCTGAACTTAGCATTTTA|TGTTAGCCGGGGCAACCGCTATCCCAAATA
GATCTACTGTCACTGTTCGGGCTATCCTTG|CCCCGTTTCGTAGTGTTAGCCGGGGCAACG
TAGCATTTTAGACGCCTACTGGCAATCTGC|ATCCCAAATAACGTTAGAACACCCCGTTTC
GTAGTGTTAGCCGGGGCAACACGGATCTAC|GCAACCCCGTTTCGTAGTGTTAACCCCGTT
CACCCCGTTTCGTAGTGTTAGCCGGGGCAA|TGTTAGCCGGGGCAACCCCGTTTCGTAGTG
GCATTAGGAGCAAAATTCCGGCCTTGCCTG|CAACGGCGTGCATCCTCGGATAATAAACCC
TCAACAACCCCGTTTCACCCCGTTTCGTAG|GTAGTGTTAGCCGGGGCAACACGGATCTAC
GGCCTCGGGTTACACCAATATAGTGGTCTA|CACTAAGGCCGCGAGGTCAGTGACTGTGTT
GTTTCGTAGTGTTAGCCGGGGCAACCGGGG|GGCTATCCTTGGCTTGCTCTGTTGCGAGCT
ACTAGAAAGTTCTTGAGGGCAAGACACGAA|TAGCCGGGGCAACAGATGTGCTCGGAGCAT
AACAGATGTGCTCGGAGCATTAGGAGCAAA|GTAGTGTTAGCCGGGGCAACGGCGTGCATC
CCCGTTTCGTAGTGTTAGCCGGGGCAACGC|AGTGTACCTAGTATAAGCGCCGAGATCCCC
ACCCCGTTTCGTAGTGTTAGCCGGGGCAAC|CAACCCCGTTTCGTAGTGTTAGCCGGGGCA
CATAGTGGGTAAATAGACGATAGTGGCCTC|CACGCATTATAAACTTTCCCTGTGCCACGA
AGTGTTAGCCGGGGCAACACCCGCAATGTA|ATGCTATGGCCAGACGCCTGATAGGTTCGT
GTGTAGGTTAATGAGATATCCGAGATTCAC|GGGCAACTCGCTCTCTTAGGTCTTTAGGCT
GCTGAACTTAGCATTTTAGACGCCTACTGG|CAACCGCTATCCCAAATAACGTTAGAACAC
GGGCAACAGATGTGCTCGGAGCATTAGGAG|TTTCGTAGTGTTAGCCGGGGCAACGGCGTG
ATAAGCGCCGAGATCCCCGAAACCCCGTTT|TCTCCACTTACGTAGCTAAGGCAACCCCGT
ACTGTGTTAGGATAGAAGGGCCCGCGAAAG|TCTCCATACCCCGTTTCGTAGTGTTAGCCG
TGAGCTTGGGCGCTGAACTTAGCATTTTAG|GTTAGCCGGGGCAACCGCTATCCCAAATAA
CGTTTCGTAGTGTTAGCCGGGGCAACGTGC|TCAAGCCCGTTGCTCTATATTACCCCGTTT
CTGGGCTTTGTTGGCCTATAGTTAAGTGTA|CGTTTCGTAGTGTTAGCCGGGGCAACGACC
ATAGTTAAGTGTACCTAGTATAAGCGCCGA|CGGGGCAACGACCTTTCACTCTCCACTTAC
GTGTTAGCACCCCGTTTCGTAGTGTTAGCC|CTGTCACTGTTCGGGCTATCCTTGGCTTGC
TCGGGTTACACCAATATAGTGGTCTACACC|AAGGCCGCGAGGTCAGTGACTGTGTTAGGA
CGTTGCTCTATATTACCCCGTTTCGTAGTG|CCGCAATGTAAGCGAGCTGCGGGAAATGAC
AGGGCCCGCGAAAGGTGTAGGTTAATGAGA|CGTAGTGTTAGCCGGGGCAACTCGCTCTCT
GATCCCCGAAACCCCGTTTCGTAGTGTTAG|GTAGCTAAGGCAACCCCGTTTCGTAGTGTT
ATTTACAGTTAGGCTTAGCCATCACTGCAA|GGTTACACCAATATAGTGGTCTACACCCCA
GAAACCCCGTTTCGTAGTGTTAGCCGGGGC|AGGCAACCCCGTTTCGTAGTGTTAGCCGGG
GCAACACTAAGGCCGCGAGGTCAGTGACTG|GAAAGTTCTTGAGGGCAAGACACGAATCTC
TGTTAGCCGGGGCAACGTGCCCGAATCTAC|TGCTCTATATTACCCCGTTTCGTAGTGTTA
TAGCCGGGGCAACACTAAGGCCGCGAGGTC|ATCTACTAGAAAGTTCTTGAGGGCAAGACA
CGATAGTGGCCTCTCCTCAAAGGCGCATAT|CCCTGTGCCACGATGAGCTTGGGCGCTGAA
CGTAGTGTTAGCCGGGGCAACCGCTATCCC|TCAACGCTAGATCGTTCGCAGTTCGTTAAC
ACAGGCCTCGGGTTACACCAATATAGTGGT|CAACACTAAGGCCGCGAGGTCAGTGACTGT
AGAAAATGACCATAGTGGGTAAATAGACGA|GTCGTTACCACACGCATTATAAACTTTCCC
TTTCGTAGTGTTAGCCGGGGCAACACTAAG|AACGTGCCCGAATCTACTAGAAAGTTCTTG
GTTCGGGCTATCCTTGGCTTGCTCTGTTGC|GTTAGCCGGGGCAACGCCGGGGCAACCACT
GAGCAAAATTCCGGCCTTGCCTGTACTAGG|GTGCATCCTCGGATAATAAACCCATCCGTT
GGCAACCACTAGATCCGGAGTCTGCCTCGT|ACCCCGTTTCGTAGTGTTAGCCGGGGCAAC
CAATCAAGGTAGATATGGTCGGTCTCTGAA|GCTCGAGCGGGTGACAGCAGGCTACGATTG
GATGTGCTCGGAGCATTAGGAGCAAAATTC|TGTTAGCCGGGGCAACGGCGTGCATCCTCG
TCGTAGTGTTAGCCGGGGCAACAGATGTGC|GAAATGACCACCCCGTTTCGTAGTGTTAGC
TTAGGTCTTTAGGCTCGTCAAGCCCGTTGC|TCGTAGTGTTAGCCGGGGCAACACCCGCAA
CATCACTGCAAACCGTCTGGGCTTTGTTGG|TCTACACCCCAAACCCCGTTTCGTAGTGTT
CCCCGTTTCGTAGTGTTAGCCGGGGCAACC|TTCGGGCTATCCTTGGCTTGCTCTGTTGCG
TGTCACTGTTCGGGCTATCCTTGGCTTGCT|TCGTAGTGTTAGCCGGGGCAACGCCGGGGC
TCAGTCGTTACCACACGCATTATAAACTTT|CCCCGTTTCGTAGTGTTAGCCGGGGCAACC
ATGGTCGGTCTCTGAAACAATATGTTATAC|CAGCAGGCTACGATTGCACTGACCACCGTC
TTAGCCGGGGCAACTCGCTCTCTTAGGTCT|CTGTACTAGGTGCGACCCCGTTTCGTAGTG
TCGTAGTGTTAGCCGGGGCAACCCCGTTTC|CCATCACTGCAAACCGTCTGGGCTTTGTTG
CAGGCTACGATTGCACTGACCACCGTCGTC|CGTTTCACCCCGTTTCGTAGTGTTAGCACC
GTTAGCCGGGGCAACCCCGTTTCGTAGTGT|TGCAAACCGTCTGGGCTTTGTTGGCCTATA
ACGATGAGCTTGGGCGCTGAACTTAGCATT|TAGTGTTAGCCGGGGCAACCGCTATCCCAA
TTAGCCGGGGCAACCGGGGCAACGTAGTGT|GCTTGCTCTGTTGCGAGCTCCGTCAACGCT
CGTTTCGTAGTGTTAGCCGGGGCAACCCCG|TTAGCCATCACTGCAAACCGTCTGGGCTTT
GGTAAATAGACGATAGTGGCCTCTCCTCAA|TATAAACTTTCCCTGTGCCACGATGAGCTT
GATATGGTCGGTCTCTGAAACAATATGTTA|TGACAGCAGGCTACGATTGCACTGACCACC
AAGTGTACCTAGTATAAGCGCCGAGATCCC|AACGACCTTTCACTCTCCACTTACGTAGCT
TGTTCGGGCTATCCTTGGCTTGCTCTGTTG|TGTTAGCCGGGGCAACGCCGGGGCAACCAC
TTCGTAGTGTTAGCCGGGGCAACTCGCTCT|CGGCCTTGCCTGTACTAGGTGCGACCCCGT
GAATCTCCATACCCCGTTTCGTAGTGTTAG|CATTAGGAGCAAAATTCCGGCCTTGCCTGT
TGTTGCGAGCTCCGTCAACGCTAGATCGTT|ACCACTAGATCCGGAGTCTGCCTCGTGTAA
ACAACCCCGTTTCACCCCGTTTCGTAGTGT|GTGTTAGCCGGGGCAACACGGATCTACTGT
GCGCTGAACTTAGCATTTTAGACGCCTACT|GGCAACCGCTATCCCAAATAACGTTAGAAC
CTTGGGCGCTGAACTTAGCATTTTAGACGC|GCCGGGGCAACCGCTATCCCAAATAACGTT
CTTAGCATTTTAGACGCCTACTGGCAATCT|CTATCCCAAATAACGTTAGAACACCCCGTT
TGAAACAATATGTTATACATTAAGAAAATG|ATTGCACTGACCACCGTCGTCAGTCGTTAC
TTCGTAGTGTTAGCCGGGGCAACGTGCCCG|AGCCCGTTGCTCTATATTACCCCGTTTCGT
ATATGGTCGGTCTCTGAAACAATATGTTAT|GACAGCAGGCTACGATTGCACTGACCACCG
GTTTCGTAGTGTTAACCCCGTTTCGTAGTG|TGTTGGCCTATAGTTAAGTGTACCTAGTAT
ATGTAAGCGAGCTGCGGGAAATGACCACCC|TTCGTATAGGTCCTGCAACATATAAGCAAA
TAGTATAAGCGCCGAGATCCCCGAAACCCC|TCACTCTCCACTTACGTAGCTAAGGCAACC
GTTTCGTAGTGTTAGCCGGGGCAACGACCT|CCGCGAAAGGTGTAGGTTAATGAGATATCC
CCCTGTGCCACGATGAGCTTGGGCGCTGAA|GGGGCAACGTAGTGTTAGCCGGGGCAACCG
CCGGGGCAACGTAGTGTTAGCCGGGGCAAC|CGAGCTCCGTCAACGCTAGATCGTTCGCAG
CAATATAGTGGTCTACACCCCAAACCCCGT|GTCAGTGACTGTGTTAGGATAGAAGGGCCC
TCGTCAAGCCCGTTGCTCTATATTACCCCG|GGGGCAACACCCGCAATGTAAGCGAGCTGC
AGGCGCATATGATCGTGTTATTTACATGAC|GGGCGCTGAACTTAGCATTTTAGACGCCTA
CGAGCTCCGTCAACGCTAGATCGTTCGCAG|TAGATCCGGAGTCTGCCTCGTGTAAACTCA
TAGTGTTAGCACCCCGTTTCGTAGTGTTAG|TACTGTCACTGTTCGGGCTATCCTTGGCTT
TTAGCATTTTAGACGCCTACTGGCAATCTG|TATCCCAAATAACGTTAGAACACCCCGTTT
CGCTAGATCGTTCGCAGTTCGTTAACACCC|TGCCTCGTGTAAACTCATTTACAGTTAGGC
TCTCCTCAAAGGCGCATATGATCGTGTTAT|GATGAGCTTGGGCGCTGAACTTAGCATTTT
CTCGCTCTCTTAGGTCTTTAGGCTCGTCAA|GACCCCGTTTCGTAGTGTTAGCCGGGGCAA
GTGGTCTACACCCCAAACCCCGTTTCGTAG|ACTGTGTTAGGATAGAAGGGCCCGCGAAAG
GGTCAGTGACTGTGTTAGGATAGAAGGGCC|GACACGAATCTCCATACCCCGTTTCGTAGT
TTTCACTCTCCACTTACGTAGCTAAGGCAA|CGAGATTCACCCCGTTTCGTAGTGTTAGCC
CGCCTACTGGCAATCTGCTCAACAACCCCG|GTTAGAACACCCCGTTTCGTAGTGTTAGCC
CAACACTAAGGCCGCGAGGTCAGTGACTGT|AAAGTTCTTGAGGGCAAGACACGAATCTCC
ACACGCATTATAAACTTTCCCTGTGCCACG|GTGTTAGCCGGGGCAACCGGGGCAACGTAG
CTACTGGCAATCTGCTCAACAACCCCGTTT|AGAACACCCCGTTTCGTAGTGTTAGCCGGG
AGCCGGGGCAACACCCGCAATGTAAGCGAG|TGGCCAGACGCCTGATAGGTTCGTATAGGT
TCGTAGTGTTAGCCGGGGCAACAGGCCTCG|TTTCGTAGTGTTAGCCGGGGCAACACTAAG
ACGCTAGATCGTTCGCAGTTCGTTAACACC|CTGCCTCGTGTAAACTCATTTACAGTTAGG
ATCCGGAGTCTGCCTCGTGTAAACTCATTT|AGTGTTAGCCGGGGCAACAGGCCTCGGGTT
TCCCCGAAACCCCGTTTCGTAGTGTTAGCC|AGCTAAGGCAACCCCGTTTCGTAGTGTTAG
ACCCCGTTTCGTAGTGTTAGCCGGGGCAAC|AGGGCCCGCGAAAGGTGTAGGTTAATGAGA
CGGCCTTGCCTGTACTAGGTGCGACCCCGT|GATAATAAACCCATCCGTTAGTCTAGAGCT
TTAACACCCCGTTTCGTAGTGTTAGCCGGG|CAGTTAGGCTTAGCCATCACTGCAAACCGT
GGTGCGACCCCGTTTCGTAGTGTTAGCCGG|TTAGTCTAGAGCTCGACTATGCTATGGCCA
TGAATTCAATCAAGGTAGATATGGTCGGTC|CGCACTGCTCGAGCGGGTGACAGCAGGCTA
TAGCCGGGGCAACTCGCTCTCTTAGGTCTT|TGTACTAGGTGCGACCCCGTTTCGTAGTGT
GCAACAGATGTGCTCGGAGCATTAGGAGCA|TCGTAGTGTTAGCCGGGGCAACGGCGTGCA
AATGACCACCCCGTTTCGTAGTGTTAGCCG|ATATAAGCAAAGACCCCCGAAACTCCTCTG
CTTGGCTTGCTCTGTTGCGAGCTCCGTCAA|AACGCCGGGGCAACCACTAGATCCGGAGTC
ATGACCACCCCGTTTCGTAGTGTTAGCCGG|TATAAGCAAAGACCCCCGAAACTCCTCTGG
CAAACCCCGTTTCGTAGTGTTAGCCGGGGC|AGAAGGGCCCGCGAAAGGTGTAGGTTAATG
GTGTACCTAGTATAAGCGCCGAGATCCCCG|CGACCTTTCACTCTCCACTTACGTAGCTAA
ATTATAAACTTTCCCTGTGCCACGATGAGC|GCCGGGGCAACCGGGGCAACGTAGTGTTAG
AGGTGTAGGTTAATGAGATATCCGAGATTC|CGGGGCAACTCGCTCTCTTAGGTCTTTAGG
GTTAACCCCGTTTCGTAGTGTTAGCCGGGG|TAGTTAAGTGTACCTAGTATAAGCGCCGAG
CAACAGGCCTCGGGTTACACCAATATAGTG|GGCAACACTAAGGCCGCGAGGTCAGTGACT
TTAACCCCGTTTCGTAGTGTTAGCCGGGGC|AGTTAAGTGTACCTAGTATAAGCGCCGAGA
ACTAAGGCCGCGAGGTCAGTGACTGTGTTA|TTCTTGAGGGCAAGACACGAATCTCCATAC
GCAACGTGCCCGAATCTACTAGAAAGTTCT|ACCCCGTTTCGTAGTGTTAGCCGGGGCAAC
GGCCTTGCCTGTACTAGGTGCGACCCCGTT|ATAATAAACCCATCCGTTAGTCTAGAGCTC
TAGTGTTAGCCGGGGCAACAGGCCTCGGGT|CGTAGTGTTAGCCGGGGCAACACTAAGGCC
ATAACGTTAGAACACCCCGTTTCGTAGTGT|CCCGTTTCGTAGTGTTAGCCGGGGCAACCC
AGTGTTAGCCGGGGCAACACTAAGGCCGCG|CCCGAATCTACTAGAAAGTTCTTGAGGGCA
ATCCTTGGCTTGCTCTGTTGCGAGCTCCGT|GGCAACGCCGGGGCAACCACTAGATCCGGA
AGTGTTAGCCGGGGCAACGCCGGGGCAACC|GTATAAGCGCCGAGATCCCCGAAACCCCGT
CCCCGTTTCGTAGTGTTAGCCGGGGCAACT|AAATTCCGGCCTTGCCTGTACTAGGTGCGA
TGGTCGGTCTCTGAAACAATATGTTATACA|AGCAGGCTACGATTGCACTGACCACCGTCG
GGGGCAACGTGCCCGAATCTACTAGAAAGT|ATTACCCCGTTTCGTAGTGTTAGCCGGGGC
AGTTCGTTAACACCCCGTTTCGTAGTGTTA|CATTTACAGTTAGGCTTAGCCATCACTGCA
CGTGTTATTTACATGACGCACTGCTCGAGC|AGCATTTTAGACGCCTACTGGCAATCTGCT
AAGGTGTAGGTTAATGAGATATCCGAGATT|CCGGGGCAACTCGCTCTCTTAGGTCTTTAG
GTAAACTCATTTACAGTTAGGCTTAGCCAT|AGGCCTCGGGTTACACCAATATAGTGGTCT
GCTAAGGCAACCCCGTTTCGTAGTGTTAGC|AGTGTTAGCCGGGGCAACGTGCCCGAATCT
TGAACTTAGCATTTTAGACGCCTACTGGCA|ACCGCTATCCCAAATAACGTTAGAACACCC
CGAGGTCAGTGACTGTGTTAGGATAGAAGG|CAAGACACGAATCTCCATACCCCGTTTCGT
CATATGATCGTGTTATTTACATGACGCACT|CTGAACTTAGCATTTTAGACGCCTACTGGC
AACAACCCCGTTTCACCCCGTTTCGTAGTG|AGTGTTAGCCGGGGCAACACGGATCTACTG
TCCTTGGCTTGCTCTGTTGCGAGCTCCGTC|GCAACGCCGGGGCAACCACTAGATCCGGAG
CAACACGGATCTACTGTCACTGTTCGGGCT|GTGTTAACCCCGTTTCGTAGTGTTAGCCGG
AGTGTTAGCCGGGGCAACAGATGTGCTCGG|TGACCACCCCGTTTCGTAGTGTTAGCCGGG
TGTTAGCCGGGGCAACGGCGTGCATCCTCG|ACTCCTCTGGAGAGCCCCGACGCGAGCTTG
AGATTCACCCCGTTTCGTAGTGTTAGCCGG|TTTAGGCTCGTCAAGCCCGTTGCTCTATAT
GCCGGGGCAACACGGATCTACTGTCACTGT|TTTCGTAGTGTTAACCCCGTTTCGTAGTGT
AGCCGGGGCAACCGCTATCCCAAATAACGT|GATCGTTCGCAGTTCGTTAACACCCCGTTT
CACTGCTCGAGCGGGTGACAGCAGGCTACG|TGGCAATCTGCTCAACAACCCCGTTTCACC
CGTTTCGTAGTGTTAGCCGGGGCAACACGG|GCCGGGGCAACCCCGTTTCGTAGTGTTAAC
GGCTCGTCAAGCCCGTTGCTCTATATTACC|GCCGGGGCAACACCCGCAATGTAAGCGAGC
TCGTAGTGTTAGCCGGGGCAACGCCGGGGC|CCTAGTATAAGCGCCGAGATCCCCGAAACC
GCAGTTCGTTAACACCCCGTTTCGTAGTGT|CTCATTTACAGTTAGGCTTAGCCATCACTG
CACCCCGTTTCGTAGTGTTAGCCGGGGCAA|GCAAAGACCCCCGAAACTCCTCTGGAGAGC
CGGGGCAACAGATGTGCTCGGAGCATTAGG|CGTTTCGTAGTGTTAGCCGGGGCAACGGCG
GCTCAACAACCCCGTTTCACCCCGTTTCGT|TCGTAGTGTTAGCCGGGGCAACACGGATCT
CCGCGAGGTCAGTGACTGTGTTAGGATAGA|GGGCAAGACACGAATCTCCATACCCCGTTT
TAAGCGCCGAGATCCCCGAAACCCCGTTTC|CTCCACTTACGTAGCTAAGGCAACCCCGTT
CTAAGGCAACCCCGTTTCGTAGTGTTAGCC|GTGTTAGCCGGGGCAACGTGCCCGAATCTA
CCGCAATGTAAGCGAGCTGCGGGAAATGAC|ATAGGTTCGTATAGGTCCTGCAACATATAA
CACCCGCAATGTAAGCGAGCTGCGGGAAAT|CTGATAGGTTCGTATAGGTCCTGCAACATA
TCGGAGCATTAGGAGCAAAATTCCGGCCTT|CGGGGCAACGGCGTGCATCCTCGGATAATA
AACGTTAGAACACCCCGTTTCGTAGTGTTA|CGTTTCGTAGTGTTAGCCGGGGCAACCCCG
CTGCCTCGTGTAAACTCATTTACAGTTAGG|CGGGGCAACAGGCCTCGGGTTACACCAATA
CTAAGGCCGCGAGGTCAGTGACTGTGTTAG|TCTTGAGGGCAAGACACGAATCTCCATACC
CCGTTTCGTAGTGTTAGCACCCCGTTTCGT|CACGGATCTACTGTCACTGTTCGGGCTATC
GTGCCACGATGAGCTTGGGCGCTGAACTTA|CAACGTAGTGTTAGCCGGGGCAACCGCTAT
GGCAACAGATGTGCTCGGAGCATTAGGAGC|TTCGTAGTGTTAGCCGGGGCAACGGCGTGC
GGATAGAAGGGCCCGCGAAAGGTGTAGGTT|CCCGTTTCGTAGTGTTAGCCGGGGCAACTC
TTCTTGAGGGCAAGACACGAATCTCCATAC|CAACAGATGTGCTCGGAGCATTAGGAGCAA
AGACACGAATCTCCATACCCCGTTTCGTAG|TCGGAGCATTAGGAGCAAAATTCCGGCCTT
CAAGGTAGATATGGTCGGTCTCTGAAACAA|GAGCGGGTGACAGCAGGCTACGATTGCACT
ACGCCGGGGCAACCACTAGATCCGGAGTCT|CCCCGAAACCCCGTTTCGTAGTGTTAGCCG
TTTAGACGCCTACTGGCAATCTGCTCAACA|AATAACGTTAGAACACCCCGTTTCGTAGTG
CGTTTCGTAGTGTTAGCCGGGGCAACCGGG|GGGCTATCCTTGGCTTGCTCTGTTGCGAGC
GCATTTTAGACGCCTACTGGCAATCTGCTC|CCCAAATAACGTTAGAACACCCCGTTTCGT
GTAGTGTTAGCCGGGGCAACAGATGTGCTC|AATGACCACCCCGTTTCGTAGTGTTAGCCG
AACACCCCGTTTCGTAGTGTTAGCCGGGGC|AGTGTTAGCCGGGGCAACCCCGTTTCGTAG
TAATGAGATATCCGAGATTCACCCCGTTTC|CGCTCTCTTAGGTCTTTAGGCTCGTCAAGC
CAACCGCTATCCCAAATAACGTTAGAACAC|GCAGTTCGTTAACACCCCGTTTCGTAGTGT
TAAGCGAGCTGCGGGAAATGACCACCCCGT|GTATAGGTCCTGCAACATATAAGCAAAGAC
AGATCCCCGAAACCCCGTTTCGTAGTGTTA|CGTAGCTAAGGCAACCCCGTTTCGTAGTGT
CCATACCCCGTTTCGTAGTGTTAGCCGGGG|GAGCAAAATTCCGGCCTTGCCTGTACTAGG
CAACCCCGTTTCGTAGTGTTAGCCGGGGCA|GCCGGGGCAACGTGCCCGAATCTACTAGAA
GCTATCCCAAATAACGTTAGAACACCCCGT|TCGTTAACACCCCGTTTCGTAGTGTTAGCC
GCCATCACTGCAAACCGTCTGGGCTTTGTT|GGTCTACACCCCAAACCCCGTTTCGTAGTG
TTCGGGCTATCCTTGGCTTGCTCTGTTGCG|TTAGCCGGGGCAACGCCGGGGCAACCACTA
