AAAAAACGCCT -> AAAAACGCCTG
AAAAAAGGGAG -> AAAAAGGGAGG
AAAAACGCCTG -> AAAACGCCTGA
AAAAAGGGAGG -> AAAAGGGAGGA
AAAAATGCATC -> AAAATGCATCT
AAAACGCCTGA -> AAACGCCTGAT
AAAACGTATCA -> AAACGTATCAT
AAAAGCAGCCC -> AAAGCAGCCCC
AAAAGGGAGGA -> AAAGGGAGGAC
AAAATGCATCT -> AAATGCATCTT
AAACAAGTAGA -> AACAAGTAGAT
AAACCCGGGTA -> AACCCGGGTAG
AAACCGTGATA -> AACCGTGATAA
AAACGCCTGAT -> AACGCCTGATT
AAACGTATCAT -> AACGTATCATC
AAACTAGACCA -> AACTAGACCAT
AAACTATCCTG -> AACTATCCTGT
AAACTGATTAC -> AACTGATTACT
AAAGATTCTTA -> AAGATTCTTAA
AAAGCAGCCCC -> AAGCAGCCCCA
AAAGCTATGCA -> AAGCTATGCAC
AAAGCTCCCCA -> AAGCTCCCCAG
AAAGGGAGGAC -> AAGGGAGGACG
AAAGGGCATTC -> AAGGGCATTCG
AAAGGTATATT -> AAGGTATATTG
AAATAAAGGGC -> AATAAAGGGCA
AAATAACCTCT -> AATAACCTCTA
AAATAATGGGG -> AATAATGGGGA
AAATAGAAGCG -> AATAGAAGCGC
AAATAGAGTGG -> AATAGAGTGGC
AAATCGTAAAT -> AATCGTAAATT
AAATCTGGCGA -> AATCTGGCGAA
AAATGCATCTT -> AATGCATCTTG
AAATTCAGCTT -> AATTCAGCTTA
AACAAATAAAG -> ACAAATAAAGG
AACAAGTAGAT -> ACAAGTAGATA
AACACGATATC -> ACACGATATCA
AACAGAGCCCG -> ACAGAGCCCGT
AACATTACCCA -> ACATTACCCAC
AACCACCTCAT -> ACCACCTCATA
AACCAGCATGG -> ACCAGCATGGG
AACCAGGTACG -> ACCAGGTACGG
AACCCAATAGT -> ACCCAATAGTG
AACCCGCCGGG -> ACCCGCCGGGG
AACCCGGGTAG -> ACCCGGGTAGG
AACCGTGATAA -> ACCGTGATAAC
AACCTCTATAC -> ACCTCTATACT
AACGACCCTAA -> ACGACCCTAAC
AACGAGTTAAG -> ACGAGTTAAGT
AACGCAGCGCC -> ACGCAGCGCCA
AACGCCCTTCG -> ACGCCCTTCGA
AACGCCGGGTG -> ACGCCGGGTGG
AACGCCTGATT -> ACGCCTGATTA
AACGCTAAAAA -> ACGCTAAAAAA
AACGGAACGAG -> ACGGAACGAGT
AACGGTCAGAA -> ACGGTCAGAAG
AACGTATCATC -> ACGTATCATCT
AACGTGAGAAG -> ACGTGAGAAGA
AACGTGCCAGT -> ACGTGCCAGTG
AACTAGACCAT -> ACTAGACCATG
AACTATCCTGT -> ACTATCCTGTT
AACTCACCACG -> ACTCACCACGT
AACTCATAAGC -> ACTCATAAGCA
AACTCCTCCCG -> ACTCCTCCCGC
AACTGAAAGCT -> ACTGAAAGCTC
AACTGAGACGT -> ACTGAGACGTG
AACTGATTACT -> ACTGATTACTG
AACTGGTTCAT -> ACTGGTTCATG
AAGAATGGATG -> AGAATGGATGT
AAGACTCAGTT -> AGACTCAGTTC
AAGAGCACCAG -> AGAGCACCAGA
AAGAGTGTCTG -> AGAGTGTCTGC
AAGATTCTTAA -> AGATTCTTAAA
AAGCACTCACG -> AGCACTCACGG
AAGCAGCCCCA -> AGCAGCCCCAA
AAGCAGCCGTA -> AGCAGCCGTAA
AAGCCACTTCT -> AGCCACTTCTG
AAGCCGGCGGG -> AGCCGGCGGGA
AAGCGCCGGCC -> AGCGCCGGCCC
AAGCGGCAACC -> AGCGGCAACCC
AAGCGTAAGGC -> AGCGTAAGGCC
AAGCGTCTCCT -> AGCGTCTCCTT
AAGCTATGCAC -> AGCTATGCACA
AAGCTCCCCAG -> AGCTCCCCAGG
AAGGCCGGATG -> AGGCCGGATGC
AAGGCGTGACA -> AGGCGTGACAT
AAGGCTTCGCA -> AGGCTTCGCAT
AAGGGAGGACG -> AGGGAGGACGG
AAGGGATGCTA -> AGGGATGCTAG
AAGGGCATTCG -> AGGGCATTCGC
AAGGTATATTG -> AGGTATATTGG
AAGTAAGGGAT -> AGTAAGGGATG
AAGTAGATAGA -> AGTAGATAGAG
AAGTCCGCTGA -> AGTCCGCTGAT
AAGTGCGTCGG -> AGTGCGTCGGC
AAGTGCGTTAT -> AGTGCGTTATT
AATAAACAAGT -> ATAAACAAGTA
AATAAAGGGCA -> ATAAAGGGCAT
AATAACCTCTA -> ATAACCTCTAT
AATAATATCTG -> ATAATATCTGG
AATAATGGGGA -> ATAATGGGGAG
AATACACACTT -> ATACACACTTC
AATACCAGTTT -> ATACCAGTTTA
AATAGAAGCGC -> ATAGAAGCGCC
AATAGAGTGGC -> ATAGAGTGGCC
AATAGGGGTTC -> ATAGGGGTTCC
AATAGTGGACG -> ATAGTGGACGC
AATATACTACA -> ATATACTACAG
AATATCTATTC -> ATATCTATTCT
AATATCTGGCT -> ATATCTGGCTC
AATATCTTTAT -> ATATCTTTATA
AATATTGATTA -> ATATTGATTAC
AATCACGGCGG -> ATCACGGCGGG
AATCACGTTTG -> ATCACGTTTGG
AATCAGCCACA -> ATCAGCCACAG
AATCATATTAT -> ATCATATTATG
AATCGAGCCCT -> ATCGAGCCCTT
AATCGTAAATT -> ATCGTAAATTC
AATCTGGCGAA -> ATCTGGCGAAA
AATGCATCTTG -> ATGCATCTTGG
AATGCGGTGGT -> ATGCGGTGGTG
AATGGACGGTG -> ATGGACGGTGA
AATGGAGAGCA -> ATGGAGAGCAA
AATGGATGTGC -> ATGGATGTGCG
AATGGGGAGGA -> ATGGGGAGGAT
AATTAACTGGT -> ATTAACTGGTT
AATTCAGCTTA -> ATTCAGCTTAA
AATTCTCAGCA -> ATTCTCAGCAT
AATTGAATCAC -> ATTGAATCACG
AATTTCGGGTA -> ATTTCGGGTAT
AATTTGACTGA -> ATTTGACTGAG
AATTTTAAAAA -> ATTTTAAAAAT
AATTTTAAGTA -> ATTTTAAGTAA
ACAAATAAAGG -> CAAATAAAGGG
ACAAATAGAGT -> CAAATAGAGTG
ACAACTGAAAG -> CAACTGAAAGC
ACAAGCCGGCG -> CAAGCCGGCGG
ACAAGTAGATA -> CAAGTAGATAG
ACAATGGACGG -> CAATGGACGGT
ACAATGGAGAG -> CAATGGAGAGC
ACACACACCAA -> CACACACCAAA
ACACACCAAAC -> CACACCAAACC
ACACACTTCCT -> CACACTTCCTT
ACACCAAACCC -> CACCAAACCCG
ACACGATATCA -> CACGATATCAA
ACACGATTGAA -> CACGATTGAAG
ACACTTCCTTC -> CACTTCCTTCG
ACAGAGCACCG -> CAGAGCACCGA
ACAGAGCCCGT -> CAGAGCCCGTT
ACAGCAACACG -> CAGCAACACGA
ACAGGACCAAC -> CAGGACCAACA
ACATCCTCAAT -> CATCCTCAATC
ACATGTACGAC -> CATGTACGACG
ACATTACCATA -> CATTACCATAC
ACATTACCCAC -> CATTACCCACG
ACCAAACCCGG -> CCAAACCCGGG
ACCAAACTAGA -> CCAAACTAGAC
ACCAACAAATA -> CCAACAAATAA
ACCACCTCATA -> CCACCTCATAT
ACCACGTATTC -> CCACGTATTCA
ACCAGAAATAG -> CCAGAAATAGA
ACCAGCATGGG -> CCAGCATGGGG
ACCAGGTACGG -> CCAGGTACGGA
ACCAGTCGCTC -> CCAGTCGCTCA
ACCAGTTTAGT -> CCAGTTTAGTA
ACCATAACAGA -> CCATAACAGAG
ACCATACCTCG -> CCATACCTCGA
ACCATGACCAT -> CCATGACCATA
ACCCAATAGTG -> CCCAATAGTGG
ACCCACGGTCG -> CCCACGGTCGC
ACCCATGGAAC -> CCCATGGAACG
ACCCCGTCATC -> CCCCGTCATCT
ACCCGCCGGGG -> CCCGCCGGGGC
ACCCGCGAAGG -> CCCGCGAAGGC
ACCCGGGTAGG -> CCCGGGTAGGG
ACCCTAACGCA -> CCCTAACGCAG
ACCCTTTGAAC -> CCCTTTGAACC
ACCGACGCGTC -> CCGACGCGTCA
ACCGTGATAAC -> CCGTGATAACC
ACCTAGTCAGA -> CCTAGTCAGAT
ACCTATTCAGA -> CCTATTCAGAT
ACCTCATATTC -> CCTCATATTCC
ACCTCGATCCG -> CCTCGATCCGT
ACCTCTATACT -> CCTCTATACTC
ACCTGCCGTTA -> CCTGCCGTTAC
ACCTGGTTTAT -> CCTGGTTTATG
ACCTTGGCCCT -> CCTTGGCCCTA
ACCTTTAATTA -> CCTTTAATTAA
ACGACCCTAAC -> CGACCCTAACG
ACGACGATACA -> CGACGATACAC
ACGACGCTGAG -> CGACGCTGAGG
ACGACGTCCAC -> CGACGTCCACC
ACGACGTTGGG -> CGACGTTGGGA
ACGAGTTAAGT -> CGAGTTAAGTG
ACGATACACAC -> CGATACACACA
ACGATAGCTTG -> CGATAGCTTGA
ACGATATCAAT -> CGATATCAATT
ACGATTGAAGC -> CGATTGAAGCG
ACGCAGCGCCA -> CGCAGCGCCAG
ACGCAGTAATT -> CGCAGTAATTC
ACGCCAAGCGT -> CGCCAAGCGTC
ACGCCCGAGCG -> CGCCCGAGCGC
ACGCCCTTCGA -> CGCCCTTCGAT
ACGCCGGGTGG -> CGCCGGGTGGT
ACGCCTGATTA -> CGCCTGATTAA
ACGCGCACAAC -> CGCGCACAACT
ACGCGTCATGT -> CGCGTCATGTA
ACGCTAAAAAA -> CGCTAAAAAAC
ACGCTGAGGAA -> CGCTGAGGAAT
ACGGAAACTGA -> CGGAAACTGAT
ACGGAACGAGT -> CGGAACGAGTT
ACGGACCCGCG -> CGGACCCGCGA
ACGGCAGTTCG -> CGGCAGTTCGT
ACGGCGGGCTA -> CGGCGGGCTAC
ACGGTCAGAAG -> CGGTCAGAAGG
ACGGTCCAATA -> CGGTCCAATAA
ACGGTCGCAGA -> CGGTCGCAGAA
ACGGTGAAACT -> CGGTGAAACTA
ACGTAACGGTC -> CGTAACGGTCA
ACGTATCATCT -> CGTATCATCTG
ACGTATTCACT -> CGTATTCACTT
ACGTCAACCCA -> CGTCAACCCAA
ACGTCCACCTA -> CGTCCACCTAT
ACGTGAGAAGA -> CGTGAGAAGAC
ACGTGCATGCT -> CGTGCATGCTT
ACGTGCCAGTG -> CGTGCCAGTGC
ACGTGCGGGGC -> CGTGCGGGGCA
ACGTGGCTTGG -> CGTGGCTTGGC
ACGTTGGGAAA -> CGTTGGGAAAA
ACGTTTCGCAA -> CGTTTCGCAAT
ACGTTTGGTGT -> CGTTTGGTGTT
ACTAATTTCGG -> CTAATTTCGGG
ACTACAGGACC -> CTACAGGACCA
ACTACGTTTCG -> CTACGTTTCGC
ACTAGACCATG -> CTAGACCATGA
ACTAGATGTTC -> CTAGATGTTCG
ACTAGGTCTAC -> CTAGGTCTACG
ACTATCCTGTT -> CTATCCTGTTT
ACTCACCACGT -> CTCACCACGTA
ACTCACGGTCC -> CTCACGGTCCA
ACTCAGTTCCG -> CTCAGTTCCGT
ACTCATAAGCA -> CTCATAAGCAG
ACTCCTCCCGC -> CTCCTCCCGCT
ACTCTTTGTAT -> CTCTTTGTATC
ACTGAAAGCTC -> CTGAAAGCTCC
ACTGAACTCAT -> CTGAACTCATA
ACTGAGACGTG -> CTGAGACGTGG
ACTGAGCCTCA -> CTGAGCCTCAT
ACTGAGGTGAG -> CTGAGGTGAGA
ACTGATTACTG -> CTGATTACTGC
ACTGCCCAGTT -> CTGCCCAGTTT
ACTGGTCGGTC -> CTGGTCGGTCA
ACTGGTTCATG -> CTGGTTCATGA
ACTTCAGGAGG -> CTTCAGGAGGC
ACTTCCTTCGA -> CTTCCTTCGAC
ACTTCTGATGC -> CTTCTGATGCC
ACTTGCTAGAA -> CTTGCTAGAAG
ACTTTGGCCGC -> CTTTGGCCGCG
AGAAAACGTAT -> GAAAACGTATC
AGAAATAGAAG -> GAAATAGAAGC
AGAAGACTCAG -> GAAGACTCAGT
AGAAGCGCCGG -> GAAGCGCCGGC
AGAAGGCGTGA -> GAAGGCGTGAC
AGAAGTGCGTC -> GAAGTGCGTCG
AGAATATTGAT -> GAATATTGATT
AGAATGGATGT -> GAATGGATGTG
AGACACGATTG -> GACACGATTGA
AGACCAAACTA -> GACCAAACTAG
AGACCATGACC -> GACCATGACCA
AGACGTCAACC -> GACGTCAACCC
AGACGTGGCTT -> GACGTGGCTTG
AGACTACGTTT -> GACTACGTTTC
AGACTCAGTTC -> GACTCAGTTCC
AGACTGGTCGG -> GACTGGTCGGT
AGAGACCAAAC -> GAGACCAAACT
AGAGATACCAG -> GAGATACCAGT
AGAGATTAGCG -> GAGATTAGCGG
AGAGCAAAGAT -> GAGCAAAGATT
AGAGCACCAGA -> GAGCACCAGAA
AGAGCACCGAC -> GAGCACCGACG
AGAGCCCGTTG -> GAGCCCGTTGT
AGAGGCATAAC -> GAGGCATAACG
AGAGTGGCCGG -> GAGTGGCCGGT
AGAGTGTCTGC -> GAGTGTCTGCT
AGATACCAGTC -> GATACCAGTCG
AGATAGAGGCA -> GATAGAGGCAT
AGATGTATCGG -> GATGTATCGGA
AGATGTTCGCC -> GATGTTCGCCG
AGATTAGCGGA -> GATTAGCGGAC
AGATTCTTAAA -> GATTCTTAAAG
AGATTGGACGA -> GATTGGACGAT
AGCAAAGATTC -> GCAAAGATTCT
AGCAACACGAT -> GCAACACGATA
AGCACCAGAAA -> GCACCAGAAAT
AGCACCGACGC -> GCACCGACGCG
AGCACTCACGG -> GCACTCACGGT
AGCAGCCCCAA -> GCAGCCCCAAC
AGCAGCCGTAA -> GCAGCCGTAAC
AGCATATATGT -> GCATATATGTT
AGCATGGGGTT -> GCATGGGGTTA
AGCCACAGAGC -> GCCACAGAGCA
AGCCACTTCTG -> GCCACTTCTGA
AGCCCCAACGC -> GCCCCAACGCT
AGCCCGTTGTA -> GCCCGTTGTAC
AGCCCTTAGTC -> GCCCTTAGTCA
AGCCGAAGAGT -> GCCGAAGAGTG
AGCCGAATAGG -> GCCGAATAGGG
AGCCGCCTAGT -> GCCGCCTAGTC
AGCCGGAGGGC -> GCCGGAGGGCC
AGCCGGCGGGA -> GCCGGCGGGAT
AGCCGTAACTG -> GCCGTAACTGA
AGCCTCATGCC -> GCCTCATGCCC
AGCGAGTAGAG -> GCGAGTAGAGA
AGCGATCAATT -> GCGATCAATTG
AGCGCCAGCCG -> GCGCCAGCCGA
AGCGCCAGCTG -> GCGCCAGCTGA
AGCGCCGGCCC -> GCGCCGGCCCG
AGCGGACTAAT -> GCGGACTAATT
AGCGGCAACCC -> GCGGCAACCCG
AGCGTAAGGCC -> GCGTAAGGCCG
AGCGTCTCCTT -> GCGTCTCCTTC
AGCTATGCACA -> GCTATGCACAG
AGCTCCCCAGG -> GCTCCCCAGGT
AGCTGACTTTG -> GCTGACTTTGG
AGCTTAATATC -> GCTTAATATCT
AGCTTGAGAGA -> GCTTGAGAGAC
AGCTTGTCCTA -> GCTTGTCCTAC
AGGAATAATAT -> GGAATAATATC
AGGACCAACAA -> GGACCAACAAA
AGGACGGAAAC -> GGACGGAAACT
AGGAGGCTGTC -> GGAGGCTGTCC
AGGATTCAAGC -> GGATTCAAGCC
AGGCATAACGA -> GGCATAACGAC
AGGCATACAAT -> GGCATACAATG
AGGCCGGATGC -> GGCCGGATGCT
AGGCGTGACAT -> GGCGTGACATC
AGGCTGTCCAT -> GGCTGTCCATG
AGGCTTCGCAT -> GGCTTCGCATA
AGGGACAAATA -> GGGACAAATAG
AGGGAGGACGG -> GGGAGGACGGA
AGGGATGCTAG -> GGGATGCTAGG
AGGGCATTCGC -> GGGCATTCGCA
AGGGCCAGACT -> GGGCCAGACTG
AGGGCGGACGT -> GGGCGGACGTG
AGGGGAATTTG -> GGGGAATTTGA
AGGGGTAACGT -> GGGGTAACGTG
AGGGGTTCCCA -> GGGGTTCCCAA
AGGGTAGCGAT -> GGGTAGCGATC
AGGGTCGTAGC -> GGGTCGTAGCC
AGGGTCTTGCA -> GGGTCTTGCAG
AGGTACGGACC -> GGTACGGACCC
AGGTATATTGG -> GGTATATTGGT
AGGTATCTTGG -> GGTATCTTGGG
AGGTATTCAAA -> GGTATTCAAAC
AGGTCTACGTA -> GGTCTACGTAA
AGGTGAGACTA -> GGTGAGACTAC
AGTAAAAGCAG -> GTAAAAGCAGC
AGTAAGGGATG -> GTAAGGGATGC
AGTAATTCTCA -> GTAATTCTCAG
AGTACGGCAGT -> GTACGGCAGTT
AGTAGAGATTA -> GTAGAGATTAG
AGTAGATAGAG -> GTAGATAGAGG
AGTCAAATAAT -> GTCAAATAATG
AGTCAGATTGG -> GTCAGATTGGA
AGTCAGTCAAA -> GTCAGTCAAAT
AGTCCATCTAT -> GTCCATCTATT
AGTCCGCTGAT -> GTCCGCTGATG
AGTCGCTCAAC -> GTCGCTCAACG
AGTCTCACGCG -> GTCTCACGCGC
AGTGCCGTTAA -> GTGCCGTTAAG
AGTGCGTCGGC -> GTGCGTCGGCA
AGTGCGTTATT -> GTGCGTTATTA
AGTGGACGCCA -> GTGGACGCCAA
AGTGGCCGGTA -> GTGGCCGGTAG
AGTGTCTGCTC -> GTGTCTGCTCC
AGTTAAGTGCG -> GTTAAGTGCGT
AGTTCCGTCAG -> GTTCCGTCAGG
AGTTCGTTGTT -> GTTCGTTGTTC
AGTTGTCAACT -> GTTGTCAACTC
AGTTTAGTACG -> GTTTAGTACGG
AGTTTTGCCAC -> GTTTTGCCACG
ATAAACAAGTA -> TAAACAAGTAG
ATAAAGGGCAT -> TAAAGGGCATT
ATAAATCTGGC -> TAAATCTGGCG
ATAACAGAGCC -> TAACAGAGCCC
ATAACCACCTC -> TAACCACCTCA
ATAACCTCTAT -> TAACCTCTATA
ATAACGACCCT -> TAACGACCCTA
ATAACGGAACG -> TAACGGAACGA
ATAAGCAGCCG -> TAAGCAGCCGT
ATAATATCTGG -> TAATATCTGGC
ATAATGGGGAG -> TAATGGGGAGG
ATACAATGGAC -> TACAATGGACG
ATACACACACC -> TACACACACCA
ATACACACTTC -> TACACACTTCC
ATACCAGTCGC -> TACCAGTCGCT
ATACCAGTTTA -> TACCAGTTTAG
ATACCTCGATC -> TACCTCGATCC
ATACTACAGGA -> TACTACAGGAC
ATACTCTTTGT -> TACTCTTTGTA
ATACTGAACTC -> TACTGAACTCA
ATAGAAGCGCC -> TAGAAGCGCCG
ATAGAGGCATA -> TAGAGGCATAA
ATAGAGTGGCC -> TAGAGTGGCCG
ATAGCTTGAGA -> TAGCTTGAGAG
ATAGGGGTTCC -> TAGGGGTTCCC
ATAGTAAAAGC -> TAGTAAAAGCA
ATAGTGGACGC -> TAGTGGACGCC
ATATAACGGAA -> TATAACGGAAC
ATATACTACAG -> TATACTACAGG
ATATATGTTCT -> TATATGTTCTG
ATATCAATTTT -> TATCAATTTTA
ATATCTATTCT -> TATCTATTCTG
ATATCTGGCTC -> TATCTGGCTCA
ATATCTTTATA -> TATCTTTATAG
ATATGCACCCT -> TATGCACCCTT
ATATGTTCTGA -> TATGTTCTGAT
ATATTATGGCG -> TATTATGGCGG
ATATTCCGTCG -> TATTCCGTCGT
ATATTGATTAC -> TATTGATTACC
ATATTGGTCTT -> TATTGGTCTTG
ATCAATTGAAT -> TCAATTGAATC
ATCAATTTTAA -> TCAATTTTAAA
ATCACGGCGGG -> TCACGGCGGGC
ATCACGTTTGG -> TCACGTTTGGT
ATCAGCCACAG -> TCAGCCACAGA
ATCATATTATG -> TCATATTATGG
ATCATCTGGAC -> TCATCTGGACC
ATCCCCGTTCT -> TCCCCGTTCTT
ATCCCGAGAGA -> TCCCGAGAGAT
ATCCCGTAGGG -> TCCCGTAGGGT
ATCCGACATTA -> TCCGACATTAC
ATCCGGTCCCC -> TCCGGTCCCCG
ATCCGTTCCTG -> TCCGTTCCTGG
ATCCTCAATCG -> TCCTCAATCGA
ATCCTGTAACA -> TCCTGTAACAT
ATCCTGTTTTA -> TCCTGTTTTAG
ATCGAGCCCTT -> TCGAGCCCTTA
ATCGGAAGTCC -> TCGGAAGTCCG
ATCGTAAATTC -> TCGTAAATTCA
ATCGTAAGCGG -> TCGTAAGCGGC
ATCTATTACCT -> TCTATTACCTG
ATCTATTCTGT -> TCTATTCTGTC
ATCTCCCCACC -> TCTCCCCACCT
ATCTGGACCTT -> TCTGGACCTTT
ATCTGGCGAAA -> TCTGGCGAAAT
ATCTGGCTCAA -> TCTGGCTCAAT
ATCTGTAATGC -> TCTGTAATGCG
ATCTTGGATCC -> TCTTGGATCCC
ATCTTGGGTCA -> TCTTGGGTCAT
ATCTTTATAGT -> TCTTTATAGTA
ATGACCATAAC -> TGACCATAACA
ATGACTAGATG -> TGACTAGATGT
ATGATGTATAC -> TGATGTATACT
ATGCACAGCAA -> TGCACAGCAAC
ATGCACCCTTT -> TGCACCCTTTG
ATGCATCTTGG -> TGCATCTTGGA
ATGCCCTGGCT -> TGCCCTGGCTC
ATGCCGTTTCG -> TGCCGTTTCGC
ATGCGAATACC -> TGCGAATACCA
ATGCGGCGGAC -> TGCGGCGGACG
ATGCGGTGGTG -> TGCGGTGGTGG
ATGCTAGGCAT -> TGCTAGGCATA
ATGCTATTCAG -> TGCTATTCAGA
ATGCTTCGCTG -> TGCTTCGCTGA
ATGGAACGTGC -> TGGAACGTGCC
ATGGACGGTGA -> TGGACGGTGAA
ATGGAGAGCAA -> TGGAGAGCAAA
ATGGATGTGCG -> TGGATGTGCGT
ATGGCGGTTAA -> TGGCGGTTAAC
ATGGGGAGGAT -> TGGGGAGGATT
ATGGGGTTAGG -> TGGGGTTAGGC
ATGTACGACGT -> TGTACGACGTC
ATGTAGTCCAT -> TGTAGTCCATC
ATGTATACTGA -> TGTATACTGAA
ATGTATCGGAA -> TGTATCGGAAG
ATGTGCGTTAC -> TGTGCGTTACC
ATGTTCGCCGT -> TGTTCGCCGTG
ATGTTCTGATC -> TGTTCTGATCG
ATGTTTCCGGC -> TGTTTCCGGCC
ATTAACGCCGG -> TTAACGCCGGG
ATTAACTGGTT -> TTAACTGGTTC
ATTACCATACC -> TTACCATACCT
ATTACCCACGG -> TTACCCACGGT
ATTACCCATGG -> TTACCCATGGA
ATTACCTGCCG -> TTACCTGCCGT
ATTACTGCCCA -> TTACTGCCCAG
ATTAGCGGACT -> TTAGCGGACTA
ATTAGGTATTC -> TTAGGTATTCA
ATTATGGCGGT -> TTATGGCGGTT
ATTCAAACCGT -> TTCAAACCGTG
ATTCAAGCCAC -> TTCAAGCCACT
ATTCACTTGCT -> TTCACTTGCTA
ATTCAGAAAAC -> TTCAGAAAACG
ATTCAGATGTA -> TTCAGATGTAT
ATTCAGCTTAA -> TTCAGCTTAAT
ATTCCGTCGTG -> TTCCGTCGTGC
ATTCGCAGCGA -> TTCGCAGCGAG
ATTCTCAGCAT -> TTCTCAGCATA
ATTCTCAGTTG -> TTCTCAGTTGT
ATTCTGTCTAA -> TTCTGTCTAAG
ATTCTTAAAGG -> TTCTTAAAGGT
ATTGAAGCGTA -> TTGAAGCGTAA
ATTGAATCACG -> TTGAATCACGG
ATTGATTACCC -> TTGATTACCCA
ATTGGACGATA -> TTGGACGATAG
ATTGGTCTTGA -> TTGGTCTTGAA
ATTGGTGCCCA -> TTGGTGCCCAG
ATTTCGGGTAT -> TTTCGGGTATC
ATTTGACTGAG -> TTTGACTGAGG
ATTTTAAAAAT -> TTTTAAAAATG
ATTTTAAGTAA -> TTTTAAGTAAG
CAAACCCGGGT -> AAACCCGGGTA
CAAACCGTGAT -> AAACCGTGATA
CAAACTAGACC -> AAACTAGACCA
CAAAGATTCTT -> AAAGATTCTTA
CAAAGCTATGC -> AAAGCTATGCA
CAAATAAAGGG -> AAATAAAGGGC
CAAATAATGGG -> AAATAATGGGG
CAAATAGAGTG -> AAATAGAGTGG
CAACAAATAAA -> AACAAATAAAG
CAACACGATAT -> AACACGATATC
CAACCAGCATG -> AACCAGCATGG
CAACCCAATAG -> AACCCAATAGT
CAACCCGCCGG -> AACCCGCCGGG
CAACGCCCTTC -> AACGCCCTTCG
CAACGCTAAAA -> AACGCTAAAAA
CAACTCCTCCC -> AACTCCTCCCG
CAACTGAAAGC -> AACTGAAAGCT
CAAGCCACTTC -> AAGCCACTTCT
CAAGCCGGCGG -> AAGCCGGCGGG
CAAGCGTCTCC -> AAGCGTCTCCT
CAAGTAGATAG -> AAGTAGATAGA
CAATAAACAAG -> AATAAACAAGT
CAATAGTGGAC -> AATAGTGGACG
CAATATACTAC -> AATATACTACA
CAATATCTATT -> AATATCTATTC
CAATCGAGCCC -> AATCGAGCCCT
CAATGGACGGT -> AATGGACGGTG
CAATGGAGAGC -> AATGGAGAGCA
CAATTGAATCA -> AATTGAATCAC
CAATTTTAAAA -> AATTTTAAAAA
CACAACTGAAA -> ACAACTGAAAG
CACACACCAAA -> ACACACCAAAC
CACACCAAACC -> ACACCAAACCC
CACACTTCCTT -> ACACTTCCTTC
CACAGAGCACC -> ACAGAGCACCG
CACAGCAACAC -> ACAGCAACACG
CACCAAACCCG -> ACCAAACCCGG
CACCACGTATT -> ACCACGTATTC
CACCAGAAATA -> ACCAGAAATAG
CACCCTTTGAA -> ACCCTTTGAAC
CACCGACGCGT -> ACCGACGCGTC
CACCTATTCAG -> ACCTATTCAGA
CACCTCATATT -> ACCTCATATTC
CACCTGGTTTA -> ACCTGGTTTAT
CACCTTGGCCC -> ACCTTGGCCCT
CACGATATCAA -> ACGATATCAAT
CACGATTGAAG -> ACGATTGAAGC
CACGCAGTAAT -> ACGCAGTAATT
CACGCCCGAGC -> ACGCCCGAGCG
CACGCGCACAA -> ACGCGCACAAC
CACGGCGGGCT -> ACGGCGGGCTA
CACGGTCCAAT -> ACGGTCCAATA
CACGGTCGCAG -> ACGGTCGCAGA
CACGTATTCAC -> ACGTATTCACT
CACGTGCGGGG -> ACGTGCGGGGC
CACGTTTGGTG -> ACGTTTGGTGT
CACTCACGGTC -> ACTCACGGTCC
CACTTCCTTCG -> ACTTCCTTCGA
CACTTCTGATG -> ACTTCTGATGC
CACTTGCTAGA -> ACTTGCTAGAA
CAGAAAACGTA -> AGAAAACGTAT
CAGAAATAGAA -> AGAAATAGAAG
CAGAAGGCGTG -> AGAAGGCGTGA
CAGAATATTGA -> AGAATATTGAT
CAGACACGATT -> AGACACGATTG
CAGACTGGTCG -> AGACTGGTCGG
CAGAGCACCGA -> AGAGCACCGAC
CAGAGCCCGTT -> AGAGCCCGTTG
CAGATGTATCG -> AGATGTATCGG
CAGATTGGACG -> AGATTGGACGA
CAGCAACACGA -> AGCAACACGAT
CAGCATATATG -> AGCATATATGT
CAGCATGGGGT -> AGCATGGGGTT
CAGCCACAGAG -> AGCCACAGAGC
CAGCCCCAACG -> AGCCCCAACGC
CAGCCGAAGAG -> AGCCGAAGAGT
CAGCCGAATAG -> AGCCGAATAGG
CAGCCGCCTAG -> AGCCGCCTAGT
CAGCCGTAACT -> AGCCGTAACTG
CAGCGAGTAGA -> AGCGAGTAGAG
CAGCGCCAGCC -> AGCGCCAGCCG
CAGCTGACTTT -> AGCTGACTTTG
CAGCTTAATAT -> AGCTTAATATC
CAGCTTGTCCT -> AGCTTGTCCTA
CAGGACCAACA -> AGGACCAACAA
CAGGAGGCTGT -> AGGAGGCTGTC
CAGGGACAAAT -> AGGGACAAATA
CAGGGCGGACG -> AGGGCGGACGT
CAGGGTAGCGA -> AGGGTAGCGAT
CAGGTACGGAC -> AGGTACGGACC
CAGGTATCTTG -> AGGTATCTTGG
CAGTAATTCTC -> AGTAATTCTCA
CAGTCAAATAA -> AGTCAAATAAT
CAGTCGCTCAA -> AGTCGCTCAAC
CAGTGCCGTTA -> AGTGCCGTTAA
CAGTTCCGTCA -> AGTTCCGTCAG
CAGTTCGTTGT -> AGTTCGTTGTT
CAGTTGTCAAC -> AGTTGTCAACT
CAGTTTAGTAC -> AGTTTAGTACG
CAGTTTTGCCA -> AGTTTTGCCAC
CATAACAGAGC -> ATAACAGAGCC
CATAACGACCC -> ATAACGACCCT
CATAAGCAGCC -> ATAAGCAGCCG
CATACAATGGA -> ATACAATGGAC
CATACCTCGAT -> ATACCTCGATC
CATATAACGGA -> ATATAACGGAA
CATATATGTTC -> ATATATGTTCT
CATATGCACCC -> ATATGCACCCT
CATATTATGGC -> ATATTATGGCG
CATATTCCGTC -> ATATTCCGTCG
CATCCCGTAGG -> ATCCCGTAGGG
CATCCTCAATC -> ATCCTCAATCG
CATCTATTACC -> ATCTATTACCT
CATCTCCCCAC -> ATCTCCCCACC
CATCTGGACCT -> ATCTGGACCTT
CATCTTGGATC -> ATCTTGGATCC
CATGACCATAA -> ATGACCATAAC
CATGATGTATA -> ATGATGTATAC
CATGCCCTGGC -> ATGCCCTGGCT
CATGCGAATAC -> ATGCGAATACC
CATGCTTCGCT -> ATGCTTCGCTG
CATGGAACGTG -> ATGGAACGTGC
CATGGGGTTAG -> ATGGGGTTAGG
CATGTACGACG -> ATGTACGACGT
CATGTAGTCCA -> ATGTAGTCCAT
CATTACCATAC -> ATTACCATACC
CATTACCCACG -> ATTACCCACGG
CATTCGCAGCG -> ATTCGCAGCGA
CATTCTCAGTT -> ATTCTCAGTTG
CATTGGTGCCC -> ATTGGTGCCCA
CCAAACCCGGG -> CAAACCCGGGT
CCAAACTAGAC -> CAAACTAGACC
CCAACAAATAA -> CAACAAATAAA
CCAACCAGCAT -> CAACCAGCATG
CCAACGCTAAA -> CAACGCTAAAA
CCAAGCGTCTC -> CAAGCGTCTCC
CCAATAAACAA -> CAATAAACAAG
CCAATAGTGGA -> CAATAGTGGAC
CCACAGAGCAC -> CACAGAGCACC
CCACCTATTCA -> CACCTATTCAG
CCACCTCATAT -> CACCTCATATT
CCACCTTGGCC -> CACCTTGGCCC
CCACGCAGTAA -> CACGCAGTAAT
CCACGCCCGAG -> CACGCCCGAGC
CCACGGTCGCA -> CACGGTCGCAG
CCACGTATTCA -> CACGTATTCAC
CCACTTCTGAT -> CACTTCTGATG
CCAGAAATAGA -> CAGAAATAGAA
CCAGACACGAT -> CAGACACGATT
CCAGACTGGTC -> CAGACTGGTCG
CCAGCATGGGG -> CAGCATGGGGT
CCAGCCGAAGA -> CAGCCGAAGAG
CCAGCCGAATA -> CAGCCGAATAG
CCAGCTGACTT -> CAGCTGACTTT
CCAGGTACGGA -> CAGGTACGGAC
CCAGGTATCTT -> CAGGTATCTTG
CCAGTCGCTCA -> CAGTCGCTCAA
CCAGTGCCGTT -> CAGTGCCGTTA
CCAGTTTAGTA -> CAGTTTAGTAC
CCAGTTTTGCC -> CAGTTTTGCCA
CCATAACAGAG -> CATAACAGAGC
CCATACCTCGA -> CATACCTCGAT
CCATCTATTAC -> CATCTATTACC
CCATGACCATA -> CATGACCATAA
CCATGCGAATA -> CATGCGAATAC
CCATGGAACGT -> CATGGAACGTG
CCCAACCAGCA -> CCAACCAGCAT
CCCAACGCTAA -> CCAACGCTAAA
CCCAATAGTGG -> CCAATAGTGGA
CCCACCTTGGC -> CCACCTTGGCC
CCCACGGTCGC -> CCACGGTCGCA
CCCAGACACGA -> CCAGACACGAT
CCCAGGTATCT -> CCAGGTATCTT
CCCAGTTTTGC -> CCAGTTTTGCC
CCCATGGAACG -> CCATGGAACGT
CCCCAACGCTA -> CCCAACGCTAA
CCCCACCTTGG -> CCCACCTTGGC
CCCCAGGTATC -> CCCAGGTATCT
CCCCCCGATGA -> CCCCCGATGAC
CCCCCGATGAC -> CCCCGATGACT
CCCCGACTAGG -> CCCGACTAGGT
CCCCGATGACT -> CCCGATGACTA
CCCCGTCATCT -> CCCGTCATCTC
CCCCGTTCTTC -> CCCGTTCTTCC
CCCGACTAGGT -> CCGACTAGGTC
CCCGAGAGATA -> CCGAGAGATAC
CCCGAGCGCCA -> CCGAGCGCCAG
CCCGATCCGAC -> CCGATCCGACA
CCCGATGACTA -> CCGATGACTAG
CCCGCCGGGGC -> CCGCCGGGGCC
CCCGCGAAGGC -> CCGCGAAGGCT
CCCGCTACTTC -> CCGCTACTTCA
CCCGGGTAGGG -> CCGGGTAGGGG
CCCGTAGGGTC -> CCGTAGGGTCT
CCCGTCATCTC -> CCGTCATCTCC
CCCGTTCTTCC -> CCGTTCTTCCA
CCCGTTGTACA -> CCGTTGTACAA
CCCTAACGCAG -> CCTAACGCAGC
CCCTAATTTTA -> CCTAATTTTAA
CCCTGGCTCAC -> CCTGGCTCACG
CCCTTAGTCAG -> CCTTAGTCAGT
CCCTTCGATCT -> CCTTCGATCTG
CCCTTTGAACC -> CCTTTGAACCA
CCGAAGAGTGT -> CGAAGAGTGTC
CCGAATAGGGG -> CGAATAGGGGT
CCGACATTACC -> CGACATTACCA
CCGACGCGTCA -> CGACGCGTCAT
CCGACTAGGTC -> CGACTAGGTCT
CCGAGAGATAC -> CGAGAGATACC
CCGAGCGCCAG -> CGAGCGCCAGC
CCGATCCGACA -> CGATCCGACAT
CCGATGACTAG -> CGATGACTAGA
CCGCCGGGGCC -> CGCCGGGGCCT
CCGCCTAGTCT -> CGCCTAGTCTC
CCGCGAAGGCT -> CGCGAAGGCTT
CCGCGCGACAA -> CGCGCGACAAT
CCGCTACTTCA -> CGCTACTTCAG
CCGCTGATGTT -> CGCTGATGTTT
CCGGAGGGCCA -> CGGAGGGCCAG
CCGGATGCTAT -> CGGATGCTATT
CCGGCCCGATC -> CGGCCCGATCC
CCGGCCTGCTA -> CGGCCTGCTAA
CCGGCGGGATA -> CGGCGGGATAA
CCGGGGCCTTC -> CGGGGCCTTCA
CCGGGTAGGGG -> CGGGTAGGGGA
CCGGGTGGTTC -> CGGGTGGTTCT
CCGGTAGGGGT -> CGGTAGGGGTA
CCGGTCCCCGA -> CGGTCCCCGAC
CCGTAACTGAG -> CGTAACTGAGA
CCGTAGGGTCT -> CGTAGGGTCTT
CCGTCAGGGCG -> CGTCAGGGCGG
CCGTCATCTCC -> CGTCATCTCCC
CCGTCGTGCTC -> CGTCGTGCTCT
CCGTGATAACC -> CGTGATAACCA
CCGTGCTTTAT -> CGTGCTTTATC
CCGTTAAGCAC -> CGTTAAGCACT
CCGTTACATGT -> CGTTACATGTA
CCGTTCCTGGG -> CGTTCCTGGGT
CCGTTCTTCCA -> CGTTCTTCCAC
CCGTTGTACAA -> CGTTGTACAAG
CCGTTTCGCTC -> CGTTTCGCTCG
CCTAACGCAGC -> CTAACGCAGCG
CCTAATTTTAA -> CTAATTTTAAG
CCTACGACGCT -> CTACGACGCTG
CCTAGTCAGAT -> CTAGTCAGATT
CCTAGTCTCAC -> CTAGTCTCACG
CCTATTCAGAT -> CTATTCAGATG
CCTCAATCGAG -> CTCAATCGAGC
CCTCATATTCC -> CTCATATTCCG
CCTCATGCCCT -> CTCATGCCCTG
CCTCCCGCTAC -> CTCCCGCTACT
CCTCGATCCGT -> CTCGATCCGTT
CCTCTATACTC -> CTCTATACTCT
CCTGATTAACG -> CTGATTAACGC
CCTGCCGTTAC -> CTGCCGTTACA
CCTGCTAATCA -> CTGCTAATCAT
CCTGGCTCACG -> CTGGCTCACGT
CCTGGGTCGCC -> CTGGGTCGCCA
CCTGGTTTATG -> CTGGTTTATGC
CCTGTAACATT -> CTGTAACATTA
CCTGTTTTAGA -> CTGTTTTAGAC
CCTTAGTCAGT -> CTTAGTCAGTC
CCTTCAAAGCT -> CTTCAAAGCTA
CCTTCATTGGT -> CTTCATTGGTG
CCTTCGACCCC -> CTTCGACCCCG
CCTTCGATCTG -> CTTCGATCTGT
CCTTGGCCCTA -> CTTGGCCCTAA
CCTTTAATTAA -> CTTTAATTAAC
CCTTTGAACCA -> CTTTGAACCAG
CGAAATAACCT -> GAAATAACCTC
CGAAGAGTGTC -> GAAGAGTGTCT
CGAAGGCTTCG -> GAAGGCTTCGC
CGAATACCAGT -> GAATACCAGTT
CGAATAGGGGT -> GAATAGGGGTT
CGACAATGGAG -> GACAATGGAGA
CGACATTACCA -> GACATTACCAT
CGACCCCGTCA -> GACCCCGTCAT
CGACCCTAACG -> GACCCTAACGC
CGACGACGATA -> GACGACGATAC
CGACGATACAC -> GACGATACACA
CGACGCGTCAT -> GACGCGTCATG
CGACGCTGAGG -> GACGCTGAGGA
CGACGTCCACC -> GACGTCCACCT
CGACGTTGGGA -> GACGTTGGGAA
CGACTAGGTCT -> GACTAGGTCTA
CGAGAGATACC -> GAGAGATACCA
CGAGCCCTTAG -> GAGCCCTTAGT
CGAGCGCCAGC -> GAGCGCCAGCT
CGAGTAGAGAT -> GAGTAGAGATT
CGAGTTAAGTG -> GAGTTAAGTGC
CGATACACACA -> GATACACACAC
CGATAGCTTGA -> GATAGCTTGAG
CGATATCAATT -> GATATCAATTT
CGATCAATTGA -> GATCAATTGAA
CGATCCGACAT -> GATCCGACATT
CGATCCGTTCC -> GATCCGTTCCT
CGATCTGTAAT -> GATCTGTAATG
CGATGACTAGA -> GATGACTAGAT
CGATTGAAGCG -> GATTGAAGCGT
CGCAATATCTA -> GCAATATCTAT
CGCACAACTGA -> GCACAACTGAA
CGCAGAATATT -> GCAGAATATTG
CGCAGCGAGTA -> GCAGCGAGTAG
CGCAGCGCCAG -> GCAGCGCCAGC
CGCAGTAATTC -> GCAGTAATTCT
CGCATATAACG -> GCATATAACGG
CGCCAAGCGTC -> GCCAAGCGTCT
CGCCAGCCGAA -> GCCAGCCGAAG,GCCAGCCGAAT
CGCCAGCTGAC -> GCCAGCTGACT
CGCCCGAGCGC -> GCCCGAGCGCC
CGCCCTTCGAT -> GCCCTTCGATC
CGCCGGCCCGA -> GCCGGCCCGAT
CGCCGGGGCCT -> GCCGGGGCCTT
CGCCGGGTGGT -> GCCGGGTGGTT
CGCCGTGCTTT -> GCCGTGCTTTA
CGCCTAGTCTC -> GCCTAGTCTCA
CGCCTGATTAA -> GCCTGATTAAC
CGCGAAGGCTT -> GCGAAGGCTTC
CGCGACAATGG -> GCGACAATGGA
CGCGCACAACT -> GCGCACAACTG
CGCGCGACAAT -> GCGCGACAATG
CGCGTCATGTA -> GCGTCATGTAG
CGCTAAAAAAC -> GCTAAAAAACG
CGCTACTTCAG -> GCTACTTCAGG
CGCTCAACGCC -> GCTCAACGCCC
CGCTCGGAATC -> GCTCGGAATCA
CGCTGAGGAAT -> GCTGAGGAATA
CGCTGAGGGTC -> GCTGAGGGTCG
CGCTGATGTTT -> GCTGATGTTTC
CGGAAACTGAT -> GGAAACTGATT
CGGAACGAGTT -> GGAACGAGTTA
CGGAAGTCCGC -> GGAAGTCCGCT
CGGAATCACGT -> GGAATCACGTT
CGGACCCGCGA -> GGACCCGCGAA
CGGACGACGTT -> GGACGACGTTG
CGGACGTGCAT -> GGACGTGCATG
CGGACTAATTT -> GGACTAATTTC
CGGAGGGCCAG -> GGAGGGCCAGA
CGGATGCTATT -> GGATGCTATTC
CGGCAACCCGC -> GGCAACCCGCC
CGGCAGGGACA -> GGCAGGGACAA
CGGCAGTTCGT -> GGCAGTTCGTT
CGGCCCGATCC -> GGCCCGATCCG
CGGCCTGCTAA -> GGCCTGCTAAT
CGGCGGACGAC -> GGCGGACGACG
CGGCGGGATAA -> GGCGGGATAAA
CGGCGGGCTAC -> GGCGGGCTACT
CGGGATAAATC -> GGGATAAATCT
CGGGCTACTGA -> GGGCTACTGAG
CGGGGCATATG -> GGGGCATATGC
CGGGGCCTTCA -> GGGGCCTTCAT
CGGGTAGGGGA -> GGGTAGGGGAA
CGGGTATCCCC -> GGGTATCCCCG
CGGGTGGTTCT -> GGGTGGTTCTT
CGGTAGGGGTA -> GGTAGGGGTAA
CGGTCACCTGG -> GGTCACCTGGT
CGGTCAGAAGG -> GGTCAGAAGGC
CGGTCCAATAA -> GGTCCAATAAA
CGGTCCCCGAC -> GGTCCCCGACT
CGGTCGCAGAA -> GGTCGCAGAAT
CGGTGAAACTA -> GGTGAAACTAT
CGGTGGTGGTC -> GGTGGTGGTCG
CGGTTAACTCA -> GGTTAACTCAC
CGTAAATTCAG -> GTAAATTCAGC
CGTAACGGTCA -> GTAACGGTCAG
CGTAACTGAGA -> GTAACTGAGAC
CGTAAGCGGCA -> GTAAGCGGCAA
CGTAAGGCCGG -> GTAAGGCCGGA
CGTAGCCGGAG -> GTAGCCGGAGG
CGTAGGGTCTT -> GTAGGGTCTTG
CGTATCATCTG -> GTATCATCTGG
CGTATTCACTT -> GTATTCACTTG
CGTCAACCCAA -> GTCAACCCAAT
CGTCAGGGCGG -> GTCAGGGCGGA
CGTCATCTCCC -> GTCATCTCCCC
CGTCATGTAGT -> GTCATGTAGTC
CGTCCACCTAT -> GTCCACCTATT
CGTCGGCAGGG -> GTCGGCAGGGA
CGTCGTGCTCT -> GTCGTGCTCTT
CGTCTCCTTCA -> GTCTCCTTCAA
CGTGACATCCT -> GTGACATCCTC
CGTGAGAAGAC -> GTGAGAAGACT
CGTGATAACCA -> GTGATAACCAC
CGTGCATGCTT -> GTGCATGCTTC
CGTGCCAGTGC -> GTGCCAGTGCC
CGTGCGGGGCA -> GTGCGGGGCAT
CGTGCTCTTAA -> GTGCTCTTAAA
CGTGCTTTATC -> GTGCTTTATCC
CGTGGCTTGGC -> GTGGCTTGGCG
CGTGGTTCATT -> GTGGTTCATTC
CGTTAAGCACT -> GTTAAGCACTC
CGTTACATGTA -> GTTACATGTAC
CGTTACCTAGT -> GTTACCTAGTC
CGTTATTAGGT -> GTTATTAGGTA
CGTTCCTGGGT -> GTTCCTGGGTC
CGTTCTTCCAC -> GTTCTTCCACG
CGTTGGGAAAA -> GTTGGGAAAAA
CGTTGTACAAG -> GTTGTACAAGC
CGTTGTTCAGC -> GTTGTTCAGCT
CGTTTCGCAAT -> GTTTCGCAATA
CGTTTCGCTCG -> GTTTCGCTCGG
CGTTTGGTGTT -> GTTTGGTGTTA
CTAAAAAACGC -> TAAAAAACGCC
CTAACGCAGCG -> TAACGCAGCGC
CTAAGAATGGA -> TAAGAATGGAT
CTAATCATATT -> TAATCATATTA
CTAATTTCGGG -> TAATTTCGGGT
CTAATTTTAAG -> TAATTTTAAGT
CTACAGGACCA -> TACAGGACCAA
CTACGACGCTG -> TACGACGCTGA
CTACGTAACGG -> TACGTAACGGT
CTACGTTTCGC -> TACGTTTCGCA
CTACTGAGCCT -> TACTGAGCCTC
CTACTTCAGGA -> TACTTCAGGAG
CTAGAAGTGCG -> TAGAAGTGCGT
CTAGACCATGA -> TAGACCATGAC
CTAGATGTTCG -> TAGATGTTCGC
CTAGGCATACA -> TAGGCATACAA
CTAGGTCTACG -> TAGGTCTACGT
CTAGTCAGATT -> TAGTCAGATTG
CTAGTCTCACG -> TAGTCTCACGC
CTATACTCTTT -> TATACTCTTTG
CTATCCTGTTT -> TATCCTGTTTT
CTATGCACAGC -> TATGCACAGCA
CTATTACCTGC -> TATTACCTGCC
CTATTCAGAAA -> TATTCAGAAAA
CTATTCAGATG -> TATTCAGATGT
CTATTCTGTCT -> TATTCTGTCTA
CTCAACGCCCT -> TCAACGCCCTT
CTCAATATACT -> TCAATATACTA
CTCAATCGAGC -> TCAATCGAGCC
CTCACCACGTA -> TCACCACGTAT
CTCACGCGCAC -> TCACGCGCACA
CTCACGGTCCA -> TCACGGTCCAA
CTCACGTGCGG -> TCACGTGCGGG
CTCAGCATATA -> TCAGCATATAT
CTCAGTTCCGT -> TCAGTTCCGTC
CTCAGTTGTCA -> TCAGTTGTCAA
CTCATAAGCAG -> TCATAAGCAGC
CTCATATTCCG -> TCATATTCCGT
CTCATGCCCTG -> TCATGCCCTGG
CTCCCCACCTT -> TCCCCACCTTG
CTCCCCAGGTA -> TCCCCAGGTAT
CTCCCCCCGAT -> TCCCCCCGATG
CTCCCGCTACT -> TCCCGCTACTT
CTCCTCCCGCT -> TCCTCCCGCTA
CTCCTTCAAAG -> TCCTTCAAAGC
CTCGATCCGTT -> TCGATCCGTTC
CTCGGAATCAC -> TCGGAATCACG
CTCTATACTCT -> TCTATACTCTT
CTCTTAAATCG -> TCTTAAATCGT
CTCTTTGTATC -> TCTTTGTATCC
CTGAAAGCTCC -> TGAAAGCTCCC
CTGAACTCATA -> TGAACTCATAA
CTGACTTTGGC -> TGACTTTGGCC
CTGAGACGTGG -> TGAGACGTGGC
CTGAGCCTCAT -> TGAGCCTCATG
CTGAGGAATAA -> TGAGGAATAAT
CTGAGGGTCGT -> TGAGGGTCGTA
CTGAGGTGAGA -> TGAGGTGAGAC
CTGATCGTAAG -> TGATCGTAAGC
CTGATGCCGTT -> TGATGCCGTTT
CTGATGTTTCC -> TGATGTTTCCG
CTGATTAACGC -> TGATTAACGCC
CTGATTACTGC -> TGATTACTGCC
CTGCCCAGTTT -> TGCCCAGTTTT
CTGCCGTTACA -> TGCCGTTACAT
CTGCTAATCAT -> TGCTAATCATA
CTGCTCCCCCC -> TGCTCCCCCCG
CTGGACCTTTA -> TGGACCTTTAA
CTGGCGAAATA -> TGGCGAAATAA
CTGGCTCAATA -> TGGCTCAATAT
CTGGCTCACGT -> TGGCTCACGTG
CTGGGTCGCCA -> TGGGTCGCCAG
CTGGTCGGTCA -> TGGTCGGTCAC
CTGGTTCATGA -> TGGTTCATGAT
CTGGTTTATGC -> TGGTTTATGCG
CTGTAACATTA -> TGTAACATTAC
CTGTAATGCGG -> TGTAATGCGGT
CTGTCCATGCG -> TGTCCATGCGA
CTGTCTAAGAA -> TGTCTAAGAAT
CTGTTTTAGAC -> TGTTTTAGACG
CTTAAAGGTAT -> TTAAAGGTATA
CTTAAATCGTA -> TTAAATCGTAA
CTTAATATCTT -> TTAATATCTTT
CTTAGTCAGTC -> TTAGTCAGTCA
CTTCAAAGCTA -> TTCAAAGCTAT
CTTCAGGAGGC -> TTCAGGAGGCT
CTTCATTGGTG -> TTCATTGGTGC
CTTCCACGCCC -> TTCCACGCCCG
CTTCCTTCGAC -> TTCCTTCGACC
CTTCGACCCCG -> TTCGACCCCGT
CTTCGATCTGT -> TTCGATCTGTA
CTTCGCATATA -> TTCGCATATAA
CTTCGCTGAGG -> TTCGCTGAGGG
CTTCTGATGCC -> TTCTGATGCCG
CTTGAAGAGCA -> TTGAAGAGCAC
CTTGAATACAC -> TTGAATACACA
CTTGAGAGACC -> TTGAGAGACCA
CTTGCAGGGTA -> TTGCAGGGTAG
CTTGCTAGAAG -> TTGCTAGAAGT
CTTGGATCCCG -> TTGGATCCCGA
CTTGGCCCTAA -> TTGGCCCTAAT
CTTGGCGTGGT -> TTGGCGTGGTT
CTTGGGTCATC -> TTGGGTCATCC
CTTGTCCTACG -> TTGTCCTACGA
CTTTAATTAAC -> TTTAATTAACT
CTTTATAGTAA -> TTTATAGTAAA
CTTTATCCGGT -> TTTATCCGGTC
CTTTGAACCAG -> TTTGAACCAGG
CTTTGGCCGCG -> TTTGGCCGCGC
CTTTGTATCCT -> TTTGTATCCTG
GAAAAAAGGGA -> AAAAAAGGGAG
GAAAACGTATC -> AAAACGTATCA
GAAACTATCCT -> AAACTATCCTG
GAAACTGATTA -> AAACTGATTAC
GAAAGCTCCCC -> AAAGCTCCCCA
GAAATAACCTC -> AAATAACCTCT
GAAATAGAAGC -> AAATAGAAGCG
GAACCAGGTAC -> AACCAGGTACG
GAACGAGTTAA -> AACGAGTTAAG
GAACGTGCCAG -> AACGTGCCAGT
GAACTCATAAG -> AACTCATAAGC
GAAGACTCAGT -> AAGACTCAGTT
GAAGAGCACCA -> AAGAGCACCAG
GAAGAGTGTCT -> AAGAGTGTCTG
GAAGCGCCGGC -> AAGCGCCGGCC
GAAGCGTAAGG -> AAGCGTAAGGC
GAAGGCGTGAC -> AAGGCGTGACA
GAAGGCTTCGC -> AAGGCTTCGCA
GAAGTCCGCTG -> AAGTCCGCTGA
GAAGTGCGTCG -> AAGTGCGTCGG
GAATAATATCT -> AATAATATCTG
GAATACACACT -> AATACACACTT
GAATACCAGTT -> AATACCAGTTT
GAATAGGGGTT -> AATAGGGGTTC
GAATATTGATT -> AATATTGATTA
GAATCACGGCG -> AATCACGGCGG
GAATCACGTTT -> AATCACGTTTG
GAATGGATGTG -> AATGGATGTGC
GAATTTGACTG -> AATTTGACTGA
GACAAATAGAG -> ACAAATAGAGT
GACAATGGAGA -> ACAATGGAGAG
GACACGATTGA -> ACACGATTGAA
GACATCCTCAA -> ACATCCTCAAT
GACATTACCAT -> ACATTACCATA
GACCAAACTAG -> ACCAAACTAGA
GACCAACAAAT -> ACCAACAAATA
GACCATAACAG -> ACCATAACAGA
GACCATGACCA -> ACCATGACCAT
GACCCCGTCAT -> ACCCCGTCATC
GACCCGCGAAG -> ACCCGCGAAGG
GACCCTAACGC -> ACCCTAACGCA
GACCTTTAATT -> ACCTTTAATTA
GACGACGATAC -> ACGACGATACA
GACGACGTTGG -> ACGACGTTGGG
GACGATACACA -> ACGATACACAC
GACGATAGCTT -> ACGATAGCTTG
GACGCCAAGCG -> ACGCCAAGCGT
GACGCGTCATG -> ACGCGTCATGT
GACGCTGAGGA -> ACGCTGAGGAA
GACGGAAACTG -> ACGGAAACTGA
GACGGTGAAAC -> ACGGTGAAACT
GACGTCAACCC -> ACGTCAACCCA
GACGTCCACCT -> ACGTCCACCTA
GACGTGCATGC -> ACGTGCATGCT
GACGTGGCTTG -> ACGTGGCTTGG
GACGTTGGGAA -> ACGTTGGGAAA
GACTAATTTCG -> ACTAATTTCGG
GACTACGTTTC -> ACTACGTTTCG
GACTAGATGTT -> ACTAGATGTTC
GACTAGGTCTA -> ACTAGGTCTAC
GACTCAGTTCC -> ACTCAGTTCCG
GACTGAGGTGA -> ACTGAGGTGAG
GACTGGTCGGT -> ACTGGTCGGTC
GACTTTGGCCG -> ACTTTGGCCGC
GAGAAGACTCA -> AGAAGACTCAG
GAGACCAAACT -> AGACCAAACTA
GAGACGTGGCT -> AGACGTGGCTT
GAGACTACGTT -> AGACTACGTTT
GAGAGACCAAA -> AGAGACCAAAC
GAGAGATACCA -> AGAGATACCAG
GAGAGCAAAGA -> AGAGCAAAGAT
GAGATACCAGT -> AGATACCAGTC
GAGATTAGCGG -> AGATTAGCGGA
GAGCAAAGATT -> AGCAAAGATTC
GAGCACCAGAA -> AGCACCAGAAA
GAGCACCGACG -> AGCACCGACGC
GAGCCCGTTGT -> AGCCCGTTGTA
GAGCCCTTAGT -> AGCCCTTAGTC
GAGCCTCATGC -> AGCCTCATGCC
GAGCGCCAGCT -> AGCGCCAGCTG
GAGGAATAATA -> AGGAATAATAT
GAGGACGGAAA -> AGGACGGAAAC
GAGGATTCAAG -> AGGATTCAAGC
GAGGCATAACG -> AGGCATAACGA
GAGGCTGTCCA -> AGGCTGTCCAT
GAGGGCCAGAC -> AGGGCCAGACT
GAGGGTCGTAG -> AGGGTCGTAGC
GAGGTGAGACT -> AGGTGAGACTA
GAGTAGAGATT -> AGTAGAGATTA
GAGTGGCCGGT -> AGTGGCCGGTA
GAGTGTCTGCT -> AGTGTCTGCTC
GAGTTAAGTGC -> AGTTAAGTGCG
GATAAATCTGG -> ATAAATCTGGC
GATAACCACCT -> ATAACCACCTC
GATACACACAC -> ATACACACACC
GATACCAGTCG -> ATACCAGTCGC
GATAGAGGCAT -> ATAGAGGCATA
GATAGCTTGAG -> ATAGCTTGAGA
GATATCAATTT -> ATATCAATTTT
GATCAATTGAA -> ATCAATTGAAT
GATCCCGAGAG -> ATCCCGAGAGA
GATCCGACATT -> ATCCGACATTA
GATCCGTTCCT -> ATCCGTTCCTG
GATCGTAAGCG -> ATCGTAAGCGG
GATCTGTAATG -> ATCTGTAATGC
GATGACTAGAT -> ATGACTAGATG
GATGCCGTTTC -> ATGCCGTTTCG
GATGCTAGGCA -> ATGCTAGGCAT
GATGCTATTCA -> ATGCTATTCAG
GATGTATACTG -> ATGTATACTGA
GATGTATCGGA -> ATGTATCGGAA
GATGTGCGTTA -> ATGTGCGTTAC
GATGTTCGCCG -> ATGTTCGCCGT
GATGTTTCCGG -> ATGTTTCCGGC
GATTAACGCCG -> ATTAACGCCGG
GATTACCCATG -> ATTACCCATGG
GATTACTGCCC -> ATTACTGCCCA
GATTAGCGGAC -> ATTAGCGGACT
GATTCAAGCCA -> ATTCAAGCCAC
GATTCTTAAAG -> ATTCTTAAAGG
GATTGAAGCGT -> ATTGAAGCGTA
GATTGGACGAT -> ATTGGACGATA
GCAAAGATTCT -> CAAAGATTCTT
GCAACACGATA -> CAACACGATAT
GCAACCCGCCG -> CAACCCGCCGG
GCAATATCTAT -> CAATATCTATT
GCACAACTGAA -> CACAACTGAAA
GCACAGCAACA -> CACAGCAACAC
GCACCAGAAAT -> CACCAGAAATA
GCACCCTTTGA -> CACCCTTTGAA
GCACCGACGCG -> CACCGACGCGT
GCACTCACGGT -> CACTCACGGTC
GCAGAATATTG -> CAGAATATTGA
GCAGCCCCAAC -> CAGCCCCAACG
GCAGCCGCCTA -> CAGCCGCCTAG
GCAGCCGTAAC -> CAGCCGTAACT
GCAGCGAGTAG -> CAGCGAGTAGA
GCAGCGCCAGC -> CAGCGCCAGCC
GCAGGGACAAA -> CAGGGACAAAT
GCAGGGTAGCG -> CAGGGTAGCGA
GCAGTAATTCT -> CAGTAATTCTC
GCAGTTCGTTG -> CAGTTCGTTGT
GCATAACGACC -> CATAACGACCC
GCATACAATGG -> CATACAATGGA
GCATATAACGG -> CATATAACGGA
GCATATATGTT -> CATATATGTTC
GCATATGCACC -> CATATGCACCC
GCATCTTGGAT -> CATCTTGGATC
GCATGCTTCGC -> CATGCTTCGCT
GCATGGGGTTA -> CATGGGGTTAG
GCATTCGCAGC -> CATTCGCAGCG
GCCAAGCGTCT -> CCAAGCGTCTC
GCCACAGAGCA -> CCACAGAGCAC
GCCACGCAGTA -> CCACGCAGTAA
GCCACTTCTGA -> CCACTTCTGAT
GCCAGACTGGT -> CCAGACTGGTC
GCCAGCCGAAG -> CCAGCCGAAGA
GCCAGCCGAAT -> CCAGCCGAATA
GCCAGCTGACT -> CCAGCTGACTT
GCCAGTGCCGT -> CCAGTGCCGTT
GCCCAGACACG -> CCCAGACACGA
GCCCAGTTTTG -> CCCAGTTTTGC
GCCCCAACGCT -> CCCCAACGCTA
GCCCGAGCGCC -> CCCGAGCGCCA
GCCCGATCCGA -> CCCGATCCGAC
GCCCGTTGTAC -> CCCGTTGTACA
GCCCTAATTTT -> CCCTAATTTTA
GCCCTGGCTCA -> CCCTGGCTCAC
GCCCTTAGTCA -> CCCTTAGTCAG
GCCCTTCGATC -> CCCTTCGATCT
GCCGAAGAGTG -> CCGAAGAGTGT
GCCGAATAGGG -> CCGAATAGGGG
GCCGCCTAGTC -> CCGCCTAGTCT
GCCGCGCGACA -> CCGCGCGACAA
GCCGGAGGGCC -> CCGGAGGGCCA
GCCGGATGCTA -> CCGGATGCTAT
GCCGGCCCGAT -> CCGGCCCGATC
GCCGGCGGGAT -> CCGGCGGGATA
GCCGGGGCCTT -> CCGGGGCCTTC
GCCGGGTGGTT -> CCGGGTGGTTC
GCCGGTAGGGG -> CCGGTAGGGGT
GCCGTAACTGA -> CCGTAACTGAG
GCCGTGCTTTA -> CCGTGCTTTAT
GCCGTTAAGCA -> CCGTTAAGCAC
GCCGTTACATG -> CCGTTACATGT
GCCGTTTCGCT -> CCGTTTCGCTC
GCCTAGTCTCA -> CCTAGTCTCAC
GCCTCATGCCC -> CCTCATGCCCT
GCCTGATTAAC -> CCTGATTAACG
GCCTGCTAATC -> CCTGCTAATCA
GCCTTCATTGG -> CCTTCATTGGT
GCGAAATAACC -> CGAAATAACCT
GCGAAGGCTTC -> CGAAGGCTTCG
GCGAATACCAG -> CGAATACCAGT
GCGACAATGGA -> CGACAATGGAG
GCGAGTAGAGA -> CGAGTAGAGAT
GCGATCAATTG -> CGATCAATTGA
GCGCACAACTG -> CGCACAACTGA
GCGCCAGCCGA -> CGCCAGCCGAA
GCGCCAGCTGA -> CGCCAGCTGAC
GCGCCGGCCCG -> CGCCGGCCCGA
GCGCGACAATG -> CGCGACAATGG
GCGGACGACGT -> CGGACGACGTT
GCGGACGTGCA -> CGGACGTGCAT
GCGGACTAATT -> CGGACTAATTT
GCGGCAACCCG -> CGGCAACCCGC
GCGGCGGACGA -> CGGCGGACGAC
GCGGGATAAAT -> CGGGATAAATC
GCGGGCTACTG -> CGGGCTACTGA
GCGGGGCATAT -> CGGGGCATATG
GCGGTGGTGGT -> CGGTGGTGGTC
GCGGTTAACTC -> CGGTTAACTCA
GCGTAAGGCCG -> CGTAAGGCCGG
GCGTCATGTAG -> CGTCATGTAGT
GCGTCGGCAGG -> CGTCGGCAGGG
GCGTCTCCTTC -> CGTCTCCTTCA
GCGTGACATCC -> CGTGACATCCT
GCGTGGTTCAT -> CGTGGTTCATT
GCGTTACCTAG -> CGTTACCTAGT
GCGTTATTAGG -> CGTTATTAGGT
GCTAAAAAACG -> CTAAAAAACGC
GCTAATCATAT -> CTAATCATATT
GCTACTGAGCC -> CTACTGAGCCT
GCTACTTCAGG -> CTACTTCAGGA
GCTAGAAGTGC -> CTAGAAGTGCG
GCTAGGCATAC -> CTAGGCATACA
GCTATGCACAG -> CTATGCACAGC
GCTATTCAGAA -> CTATTCAGAAA
GCTCAACGCCC -> CTCAACGCCCT
GCTCAATATAC -> CTCAATATACT
GCTCACGTGCG -> CTCACGTGCGG
GCTCCCCAGGT -> CTCCCCAGGTA
GCTCCCCCCGA -> CTCCCCCCGAT
GCTCGGAATCA -> CTCGGAATCAC
GCTCTTAAATC -> CTCTTAAATCG
GCTGACTTTGG -> CTGACTTTGGC
GCTGAGGAATA -> CTGAGGAATAA
GCTGAGGGTCG -> CTGAGGGTCGT
GCTGATGTTTC -> CTGATGTTTCC
GCTGTCCATGC -> CTGTCCATGCG
GCTTAATATCT -> CTTAATATCTT
GCTTCGCATAT -> CTTCGCATATA
GCTTCGCTGAG -> CTTCGCTGAGG
GCTTGAGAGAC -> CTTGAGAGACC
GCTTGGCGTGG -> CTTGGCGTGGT
GCTTGTCCTAC -> CTTGTCCTACG
GCTTTATCCGG -> CTTTATCCGGT
GGAAAAAAGGG -> GAAAAAAGGGA
GGAAACTGATT -> GAAACTGATTA
GGAACGAGTTA -> GAACGAGTTAA
GGAACGTGCCA -> GAACGTGCCAG
GGAAGTCCGCT -> GAAGTCCGCTG
GGAATAATATC -> GAATAATATCT
GGAATCACGTT -> GAATCACGTTT
GGAATTTGACT -> GAATTTGACTG
GGACAAATAGA -> GACAAATAGAG
GGACCAACAAA -> GACCAACAAAT
GGACCCGCGAA -> GACCCGCGAAG
GGACCTTTAAT -> GACCTTTAATT
GGACGACGTTG -> GACGACGTTGG
GGACGATAGCT -> GACGATAGCTT
GGACGCCAAGC -> GACGCCAAGCG
GGACGGAAACT -> GACGGAAACTG
GGACGGTGAAA -> GACGGTGAAAC
GGACGTGCATG -> GACGTGCATGC
GGACTAATTTC -> GACTAATTTCG
GGAGAGCAAAG -> GAGAGCAAAGA
GGAGGACGGAA -> GAGGACGGAAA
GGAGGATTCAA -> GAGGATTCAAG
GGAGGCTGTCC -> GAGGCTGTCCA
GGAGGGCCAGA -> GAGGGCCAGAC
GGATAAATCTG -> GATAAATCTGG
GGATCCCGAGA -> GATCCCGAGAG
GGATGCTAGGC -> GATGCTAGGCA
GGATGCTATTC -> GATGCTATTCA
GGATGTGCGTT -> GATGTGCGTTA
GGATTCAAGCC -> GATTCAAGCCA
GGCAACCCGCC -> GCAACCCGCCG
GGCAGCCGCCT -> GCAGCCGCCTA
GGCAGGGACAA -> GCAGGGACAAA
GGCAGTTCGTT -> GCAGTTCGTTG
GGCATAACGAC -> GCATAACGACC
GGCATACAATG -> GCATACAATGG
GGCATATGCAC -> GCATATGCACC
GGCATTCGCAG -> GCATTCGCAGC
GGCCAGACTGG -> GCCAGACTGGT
GGCCCGATCCG -> GCCCGATCCGA
GGCCCTAATTT -> GCCCTAATTTT
GGCCGCGCGAC -> GCCGCGCGACA
GGCCGGATGCT -> GCCGGATGCTA
GGCCGGTAGGG -> GCCGGTAGGGG
GGCCTGCTAAT -> GCCTGCTAATC
GGCCTTCATTG -> GCCTTCATTGG
GGCGAAATAAC -> GCGAAATAACC
GGCGGACGACG -> GCGGACGACGT
GGCGGACGTGC -> GCGGACGTGCA
GGCGGGATAAA -> GCGGGATAAAT
GGCGGGCTACT -> GCGGGCTACTG
GGCGGTTAACT -> GCGGTTAACTC
GGCGTGACATC -> GCGTGACATCC
GGCGTGGTTCA -> GCGTGGTTCAT
GGCTACTGAGC -> GCTACTGAGCC
GGCTCAATATA -> GCTCAATATAC
GGCTCACGTGC -> GCTCACGTGCG
GGCTGTCCATG -> GCTGTCCATGC
GGCTTCGCATA -> GCTTCGCATAT
GGCTTGGCGTG -> GCTTGGCGTGG
GGGAAAAAAGG -> GGAAAAAAGGG
GGGAATTTGAC -> GGAATTTGACT
GGGACAAATAG -> GGACAAATAGA
GGGAGGACGGA -> GGAGGACGGAA
GGGAGGATTCA -> GGAGGATTCAA
GGGATAAATCT -> GGATAAATCTG
GGGATGCTAGG -> GGATGCTAGGC
GGGCATATGCA -> GGCATATGCAC
GGGCATTCGCA -> GGCATTCGCAG
GGGCCAGACTG -> GGCCAGACTGG
GGGCCTTCATT -> GGCCTTCATTG
GGGCGGACGTG -> GGCGGACGTGC
GGGCTACTGAG -> GGCTACTGAGC
GGGGAATTTGA -> GGGAATTTGAC
GGGGAGGATTC -> GGGAGGATTCA
GGGGCATATGC -> GGGCATATGCA
GGGGCCTTCAT -> GGGCCTTCATT
GGGGTAACGTG -> GGGTAACGTGA
GGGGTTCCCAA -> GGGTTCCCAAC
GGGTAACGTGA -> GGTAACGTGAG
GGGTAGCGATC -> GGTAGCGATCA
GGGTAGGGGAA -> GGTAGGGGAAT
GGGTATCCCCG -> GGTATCCCCGT
GGGTCATCCCG -> GGTCATCCCGT
GGGTCGCCAGC -> GGTCGCCAGCC
GGGTCGTAGCC -> GGTCGTAGCCG
GGGTCTTGCAG -> GGTCTTGCAGG
GGGTGGTTCTT -> GGTGGTTCTTG
GGGTTCCCAAC -> GGTTCCCAACC
GGTAACGTGAG -> GTAACGTGAGA
GGTACGGACCC -> GTACGGACCCG
GGTAGCGATCA -> GTAGCGATCAA
GGTAGGGGAAT -> GTAGGGGAATT
GGTAGGGGTAA -> GTAGGGGTAAC
GGTATATTGGT -> GTATATTGGTC
GGTATCCCCGT -> GTATCCCCGTT
GGTATCTTGGG -> GTATCTTGGGT
GGTATTCAAAC -> GTATTCAAACC
GGTCACCTGGT -> GTCACCTGGTT
GGTCAGAAGGC -> GTCAGAAGGCG
GGTCATCCCGT -> GTCATCCCGTA
GGTCCAATAAA -> GTCCAATAAAC
GGTCCCCGACT -> GTCCCCGACTA
GGTCGACGACG -> GTCGACGACGA
GGTCGCAGAAT -> GTCGCAGAATA
GGTCGCCAGCC -> GTCGCCAGCCG
GGTCGGTCACC -> GTCGGTCACCT
GGTCGTAGCCG -> GTCGTAGCCGG
GGTCTACGTAA -> GTCTACGTAAC
GGTCTTGAAGA -> GTCTTGAAGAG
GGTCTTGCAGG -> GTCTTGCAGGG
GGTGAAACTAT -> GTGAAACTATC
GGTGAGACTAC -> GTGAGACTACG
GGTGCCCAGAC -> GTGCCCAGACA
GGTGGTCGACG -> GTGGTCGACGA
GGTGGTGGTCG -> GTGGTGGTCGA
GGTGGTTCTTG -> GTGGTTCTTGA
GGTGTTAATCA -> GTGTTAATCAG
GGTTAACTCAC -> GTTAACTCACC
GGTTCATGATG -> GTTCATGATGT
GGTTCATTCTC -> GTTCATTCTCA
GGTTCCCAACC -> GTTCCCAACCA
GGTTCTTGAAT -> GTTCTTGAATA
GGTTTATGCGG -> GTTTATGCGGC
GTAAAAGCAGC -> TAAAAGCAGCC
GTAAATTCAGC -> TAAATTCAGCT
GTAACATTACC -> TAACATTACCC
GTAACGGTCAG -> TAACGGTCAGA
GTAACGTGAGA -> TAACGTGAGAA
GTAACTGAGAC -> TAACTGAGACG
GTAAGCGGCAA -> TAAGCGGCAAC
GTAAGGCCGGA -> TAAGGCCGGAT
GTAAGGGATGC -> TAAGGGATGCT
GTAATGCGGTG -> TAATGCGGTGG
GTAATTCTCAG -> TAATTCTCAGC
GTACAAGCCGG -> TACAAGCCGGC
GTACGACGTCC -> TACGACGTCCA
GTACGGACCCG -> TACGGACCCGC
GTACGGCAGTT -> TACGGCAGTTC
GTAGAGATTAG -> TAGAGATTAGC
GTAGATAGAGG -> TAGATAGAGGC
GTAGCCGGAGG -> TAGCCGGAGGG
GTAGCGATCAA -> TAGCGATCAAT
GTAGGGGAATT -> TAGGGGAATTT
GTAGGGGTAAC -> TAGGGGTAACG
GTAGGGTCTTG -> TAGGGTCTTGC
GTAGTCCATCT -> TAGTCCATCTA
GTATACTGAAC -> TATACTGAACT
GTATATTGGTC -> TATATTGGTCT
GTATCATCTGG -> TATCATCTGGA
GTATCCCCGTT -> TATCCCCGTTC
GTATCCTGTAA -> TATCCTGTAAC
GTATCGGAAGT -> TATCGGAAGTC
GTATCTTGGGT -> TATCTTGGGTC
GTATTCAAACC -> TATTCAAACCG
GTATTCACTTG -> TATTCACTTGC
GTCAAATAATG -> TCAAATAATGG
GTCAACCCAAT -> TCAACCCAATA
GTCAACTCCTC -> TCAACTCCTCC
GTCACCTGGTT -> TCACCTGGTTT
GTCAGAAGGCG -> TCAGAAGGCGT
GTCAGATTGGA -> TCAGATTGGAC
GTCAGGGCGGA -> TCAGGGCGGAC
GTCAGTCAAAT -> TCAGTCAAATA
GTCATCCCGTA -> TCATCCCGTAG
GTCATCTCCCC -> TCATCTCCCCA
GTCATGTAGTC -> TCATGTAGTCC
GTCCAATAAAC -> TCCAATAAACA
GTCCACCTATT -> TCCACCTATTC
GTCCATCTATT -> TCCATCTATTA
GTCCATGCGAA -> TCCATGCGAAT
GTCCCCGACTA -> TCCCCGACTAG
GTCCGCTGATG -> TCCGCTGATGT
GTCCTACGACG -> TCCTACGACGC
GTCGACGACGA -> TCGACGACGAT
GTCGCAGAATA -> TCGCAGAATAT
GTCGCCAGCCG -> TCGCCAGCCGA
GTCGCTCAACG -> TCGCTCAACGC
GTCGGCAGGGA -> TCGGCAGGGAC
GTCGGTCACCT -> TCGGTCACCTG
GTCGTAGCCGG -> TCGTAGCCGGA
GTCGTGCTCTT -> TCGTGCTCTTA
GTCTAAGAATG -> TCTAAGAATGG
GTCTACGTAAC -> TCTACGTAACG
GTCTCACGCGC -> TCTCACGCGCA
GTCTCCTTCAA -> TCTCCTTCAAA
GTCTGCTCCCC -> TCTGCTCCCCC
GTCTTGAAGAG -> TCTTGAAGAGC
GTCTTGCAGGG -> TCTTGCAGGGT
GTGAAACTATC -> TGAAACTATCC
GTGACATCCTC -> TGACATCCTCA
GTGAGAAGACT -> TGAGAAGACTC
GTGAGACTACG -> TGAGACTACGT
GTGATAACCAC -> TGATAACCACC
GTGCATGCTTC -> TGCATGCTTCG
GTGCCAGTGCC -> TGCCAGTGCCG
GTGCCCAGACA -> TGCCCAGACAC
GTGCCGTTAAG -> TGCCGTTAAGC
GTGCGGGGCAT -> TGCGGGGCATA
GTGCGTCGGCA -> TGCGTCGGCAG
GTGCGTTACCT -> TGCGTTACCTA
GTGCGTTATTA -> TGCGTTATTAG
GTGCTCTTAAA -> TGCTCTTAAAT
GTGCTTTATCC -> TGCTTTATCCG
GTGGACGCCAA -> TGGACGCCAAG
GTGGCCGGTAG -> TGGCCGGTAGG
GTGGCTTGGCG -> TGGCTTGGCGT
GTGGTCGACGA -> TGGTCGACGAC
GTGGTGGTCGA -> TGGTGGTCGAC
GTGGTTCATTC -> TGGTTCATTCT
GTGGTTCTTGA -> TGGTTCTTGAA
GTGTCTGCTCC -> TGTCTGCTCCC
GTGTTAATCAG -> TGTTAATCAGC
GTTAACTCACC -> TTAACTCACCA
GTTAAGCACTC -> TTAAGCACTCA
GTTAAGTGCGT -> TTAAGTGCGTT
GTTAATCAGCC -> TTAATCAGCCA
GTTACATGTAC -> TTACATGTACG
GTTACCTAGTC -> TTACCTAGTCA
GTTATTAGGTA -> TTATTAGGTAT
GTTCAGCTTGT -> TTCAGCTTGTC
GTTCATGATGT -> TTCATGATGTA
GTTCATTCTCA -> TTCATTCTCAG
GTTCCCAACCA -> TTCCCAACCAG
GTTCCGTCAGG -> TTCCGTCAGGG
GTTCCTGGGTC -> TTCCTGGGTCG
GTTCGCCGTGC -> TTCGCCGTGCT
GTTCGTTGTTC -> TTCGTTGTTCA
GTTCTGATCGT -> TTCTGATCGTA
GTTCTTCCACG -> TTCTTCCACGC
GTTCTTGAATA -> TTCTTGAATAC
GTTGGGAAAAA -> TTGGGAAAAAA
GTTGTACAAGC -> TTGTACAAGCC
GTTGTCAACTC -> TTGTCAACTCC
GTTGTTCAGCT -> TTGTTCAGCTT
GTTTAGTACGG -> TTTAGTACGGC
GTTTATGCGGC -> TTTATGCGGCG
GTTTCCGGCCT -> TTTCCGGCCTG
GTTTCGCAATA -> TTTCGCAATAT
GTTTCGCTCGG -> TTTCGCTCGGA
GTTTGGTGTTA -> TTTGGTGTTAA
GTTTTAGACGT -> TTTTAGACGTC
GTTTTGCCACG -> TTTTGCCACGC
TAAAAAACGCC -> AAAAAACGCCT
TAAAAATGCAT -> AAAAATGCATC
TAAAAGCAGCC -> AAAAGCAGCCC
TAAACAAGTAG -> AAACAAGTAGA
TAAAGGGCATT -> AAAGGGCATTC
TAAAGGTATAT -> AAAGGTATATT
TAAATCGTAAA -> AAATCGTAAAT
TAAATCTGGCG -> AAATCTGGCGA
TAAATTCAGCT -> AAATTCAGCTT
TAACAGAGCCC -> AACAGAGCCCG
TAACATTACCC -> AACATTACCCA
TAACCACCTCA -> AACCACCTCAT
TAACCTCTATA -> AACCTCTATAC
TAACGACCCTA -> AACGACCCTAA
TAACGCAGCGC -> AACGCAGCGCC
TAACGCCGGGT -> AACGCCGGGTG
TAACGGAACGA -> AACGGAACGAG
TAACGGTCAGA -> AACGGTCAGAA
TAACGTGAGAA -> AACGTGAGAAG
TAACTCACCAC -> AACTCACCACG
TAACTGAGACG -> AACTGAGACGT
TAACTGGTTCA -> AACTGGTTCAT
TAAGAATGGAT -> AAGAATGGATG
TAAGCACTCAC -> AAGCACTCACG
TAAGCAGCCGT -> AAGCAGCCGTA
TAAGCGGCAAC -> AAGCGGCAACC
TAAGGCCGGAT -> AAGGCCGGATG
TAAGGGATGCT -> AAGGGATGCTA
TAAGTAAGGGA -> AAGTAAGGGAT
TAAGTGCGTTA -> AAGTGCGTTAT
TAATATCTGGC -> AATATCTGGCT
TAATATCTTTA -> AATATCTTTAT
TAATCAGCCAC -> AATCAGCCACA
TAATCATATTA -> AATCATATTAT
TAATGCGGTGG -> AATGCGGTGGT
TAATGGGGAGG -> AATGGGGAGGA
TAATTAACTGG -> AATTAACTGGT
TAATTCTCAGC -> AATTCTCAGCA
TAATTTCGGGT -> AATTTCGGGTA
TAATTTTAAGT -> AATTTTAAGTA
TACAAGCCGGC -> ACAAGCCGGCG
TACAATGGACG -> ACAATGGACGG
TACACACACCA -> ACACACACCAA
TACACACTTCC -> ACACACTTCCT
TACAGGACCAA -> ACAGGACCAAC
TACATGTACGA -> ACATGTACGAC
TACCAGTCGCT -> ACCAGTCGCTC
TACCAGTTTAG -> ACCAGTTTAGT
TACCATACCTC -> ACCATACCTCG
TACCCACGGTC -> ACCCACGGTCG
TACCCATGGAA -> ACCCATGGAAC
TACCTAGTCAG -> ACCTAGTCAGA
TACCTCGATCC -> ACCTCGATCCG
TACCTGCCGTT -> ACCTGCCGTTA
TACGACGCTGA -> ACGACGCTGAG
TACGACGTCCA -> ACGACGTCCAC
TACGGACCCGC -> ACGGACCCGCG
TACGGCAGTTC -> ACGGCAGTTCG
TACGTAACGGT -> ACGTAACGGTC
TACGTTTCGCA -> ACGTTTCGCAA
TACTACAGGAC -> ACTACAGGACC
TACTCTTTGTA -> ACTCTTTGTAT
TACTGAACTCA -> ACTGAACTCAT
TACTGAGCCTC -> ACTGAGCCTCA
TACTGCCCAGT -> ACTGCCCAGTT
TACTTCAGGAG -> ACTTCAGGAGG
TAGAAGCGCCG -> AGAAGCGCCGG
TAGAAGTGCGT -> AGAAGTGCGTC
TAGACCATGAC -> AGACCATGACC
TAGACGTCAAC -> AGACGTCAACC
TAGAGATTAGC -> AGAGATTAGCG
TAGAGGCATAA -> AGAGGCATAAC
TAGAGTGGCCG -> AGAGTGGCCGG
TAGATAGAGGC -> AGATAGAGGCA
TAGATGTTCGC -> AGATGTTCGCC
TAGCCGGAGGG -> AGCCGGAGGGC
TAGCGATCAAT -> AGCGATCAATT
TAGCGGACTAA -> AGCGGACTAAT
TAGCTTGAGAG -> AGCTTGAGAGA
TAGGCATACAA -> AGGCATACAAT
TAGGGGAATTT -> AGGGGAATTTG
TAGGGGTAACG -> AGGGGTAACGT
TAGGGGTTCCC -> AGGGGTTCCCA
TAGGGTCTTGC -> AGGGTCTTGCA
TAGGTATTCAA -> AGGTATTCAAA
TAGGTCTACGT -> AGGTCTACGTA
TAGTAAAAGCA -> AGTAAAAGCAG
TAGTACGGCAG -> AGTACGGCAGT
TAGTCAGATTG -> AGTCAGATTGG
TAGTCAGTCAA -> AGTCAGTCAAA
TAGTCCATCTA -> AGTCCATCTAT
TAGTCTCACGC -> AGTCTCACGCG
TAGTGGACGCC -> AGTGGACGCCA
TATAACGGAAC -> ATAACGGAACG
TATACTACAGG -> ATACTACAGGA
TATACTCTTTG -> ATACTCTTTGT
TATACTGAACT -> ATACTGAACTC
TATAGTAAAAG -> ATAGTAAAAGC
TATATGTTCTG -> ATATGTTCTGA
TATATTGGTCT -> ATATTGGTCTT
TATCAATTTTA -> ATCAATTTTAA
TATCATCTGGA -> ATCATCTGGAC
TATCCCCGTTC -> ATCCCCGTTCT
TATCCGGTCCC -> ATCCGGTCCCC
TATCCTGTAAC -> ATCCTGTAACA
TATCCTGTTTT -> ATCCTGTTTTA
TATCGGAAGTC -> ATCGGAAGTCC
TATCTATTCTG -> ATCTATTCTGT
TATCTGGCTCA -> ATCTGGCTCAA
TATCTTGGGTC -> ATCTTGGGTCA
TATCTTTATAG -> ATCTTTATAGT
TATGCACAGCA -> ATGCACAGCAA
TATGCACCCTT -> ATGCACCCTTT
TATGCGGCGGA -> ATGCGGCGGAC
TATGGCGGTTA -> ATGGCGGTTAA
TATGTTCTGAT -> ATGTTCTGATC
TATTACCTGCC -> ATTACCTGCCG
TATTAGGTATT -> ATTAGGTATTC
TATTATGGCGG -> ATTATGGCGGT
TATTCAAACCG -> ATTCAAACCGT
TATTCACTTGC -> ATTCACTTGCT
TATTCAGAAAA -> ATTCAGAAAAC
TATTCAGATGT -> ATTCAGATGTA
TATTCCGTCGT -> ATTCCGTCGTG
TATTCTGTCTA -> ATTCTGTCTAA
TATTGATTACC -> ATTGATTACCC
TATTGGTCTTG -> ATTGGTCTTGA
TCAAACCGTGA -> CAAACCGTGAT
TCAAAGCTATG -> CAAAGCTATGC
TCAAATAATGG -> CAAATAATGGG
TCAACCCAATA -> CAACCCAATAG
TCAACGCCCTT -> CAACGCCCTTC
TCAACTCCTCC -> CAACTCCTCCC
TCAAGCCACTT -> CAAGCCACTTC
TCAATATACTA -> CAATATACTAC
TCAATCGAGCC -> CAATCGAGCCC
TCAATTGAATC -> CAATTGAATCA
TCAATTTTAAA -> CAATTTTAAAA
TCACCACGTAT -> CACCACGTATT
TCACCTGGTTT -> CACCTGGTTTA
TCACGCGCACA -> CACGCGCACAA
TCACGGCGGGC -> CACGGCGGGCT
TCACGGTCCAA -> CACGGTCCAAT
TCACGTGCGGG -> CACGTGCGGGG
TCACGTTTGGT -> CACGTTTGGTG
TCACTTGCTAG -> CACTTGCTAGA
TCAGAAAACGT -> CAGAAAACGTA
TCAGAAGGCGT -> CAGAAGGCGTG
TCAGATGTATC -> CAGATGTATCG
TCAGATTGGAC -> CAGATTGGACG
TCAGCATATAT -> CAGCATATATG
TCAGCCACAGA -> CAGCCACAGAG
TCAGCTTAATA -> CAGCTTAATAT
TCAGCTTGTCC -> CAGCTTGTCCT
TCAGGAGGCTG -> CAGGAGGCTGT
TCAGGGCGGAC -> CAGGGCGGACG
TCAGTCAAATA -> CAGTCAAATAA
TCAGTTCCGTC -> CAGTTCCGTCA
TCAGTTGTCAA -> CAGTTGTCAAC
TCATAAGCAGC -> CATAAGCAGCC
TCATATTATGG -> CATATTATGGC
TCATATTCCGT -> CATATTCCGTC
TCATCCCGTAG -> CATCCCGTAGG
TCATCTCCCCA -> CATCTCCCCAC
TCATCTGGACC -> CATCTGGACCT
TCATGATGTAT -> CATGATGTATA
TCATGCCCTGG -> CATGCCCTGGC
TCATGTAGTCC -> CATGTAGTCCA
TCATTCTCAGT -> CATTCTCAGTT
TCATTGGTGCC -> CATTGGTGCCC
TCCAATAAACA -> CCAATAAACAA
TCCACCTATTC -> CCACCTATTCA
TCCACGCCCGA -> CCACGCCCGAG
TCCATCTATTA -> CCATCTATTAC
TCCATGCGAAT -> CCATGCGAATA
TCCCAACCAGC -> CCCAACCAGCA
TCCCCACCTTG -> CCCCACCTTGG
TCCCCAGGTAT -> CCCCAGGTATC
TCCCCCCGATG -> CCCCCCGATGA
TCCCCGACTAG -> CCCCGACTAGG
TCCCCGTTCTT -> CCCCGTTCTTC
TCCCGAGAGAT -> CCCGAGAGATA
TCCCGCTACTT -> CCCGCTACTTC
TCCCGTAGGGT -> CCCGTAGGGTC
TCCGACATTAC -> CCGACATTACC
TCCGCTGATGT -> CCGCTGATGTT
TCCGGCCTGCT -> CCGGCCTGCTA
TCCGGTCCCCG -> CCGGTCCCCGA
TCCGTCAGGGC -> CCGTCAGGGCG
TCCGTCGTGCT -> CCGTCGTGCTC
TCCGTTCCTGG -> CCGTTCCTGGG
TCCTACGACGC -> CCTACGACGCT
TCCTCAATCGA -> CCTCAATCGAG
TCCTCCCGCTA -> CCTCCCGCTAC
TCCTGGGTCGC -> CCTGGGTCGCC
TCCTGTAACAT -> CCTGTAACATT
TCCTGTTTTAG -> CCTGTTTTAGA
TCCTTCAAAGC -> CCTTCAAAGCT
TCCTTCGACCC -> CCTTCGACCCC
TCGACCCCGTC -> CGACCCCGTCA
TCGACGACGAT -> CGACGACGATA
TCGAGCCCTTA -> CGAGCCCTTAG
TCGATCCGTTC -> CGATCCGTTCC
TCGATCTGTAA -> CGATCTGTAAT
TCGCAATATCT -> CGCAATATCTA
TCGCAGAATAT -> CGCAGAATATT
TCGCAGCGAGT -> CGCAGCGAGTA
TCGCATATAAC -> CGCATATAACG
TCGCCAGCCGA -> CGCCAGCCGAA
TCGCCGTGCTT -> CGCCGTGCTTT
TCGCTCAACGC -> CGCTCAACGCC
TCGCTCGGAAT -> CGCTCGGAATC
TCGCTGAGGGT -> CGCTGAGGGTC
TCGGAAGTCCG -> CGGAAGTCCGC
TCGGAATCACG -> CGGAATCACGT
TCGGCAGGGAC -> CGGCAGGGACA
TCGGGTATCCC -> CGGGTATCCCC
TCGGTCACCTG -> CGGTCACCTGG
TCGTAAATTCA -> CGTAAATTCAG
TCGTAAGCGGC -> CGTAAGCGGCA
TCGTAGCCGGA -> CGTAGCCGGAG
TCGTGCTCTTA -> CGTGCTCTTAA
TCGTTGTTCAG -> CGTTGTTCAGC
TCTAAGAATGG -> CTAAGAATGGA
TCTACGTAACG -> CTACGTAACGG
TCTATACTCTT -> CTATACTCTTT
TCTATTACCTG -> CTATTACCTGC
TCTATTCTGTC -> CTATTCTGTCT
TCTCACGCGCA -> CTCACGCGCAC
TCTCAGCATAT -> CTCAGCATATA
TCTCAGTTGTC -> CTCAGTTGTCA
TCTCCCCACCT -> CTCCCCACCTT
TCTCCTTCAAA -> CTCCTTCAAAG
TCTGATCGTAA -> CTGATCGTAAG
TCTGATGCCGT -> CTGATGCCGTT
TCTGCTCCCCC -> CTGCTCCCCCC
TCTGGACCTTT -> CTGGACCTTTA
TCTGGCGAAAT -> CTGGCGAAATA
TCTGGCTCAAT -> CTGGCTCAATA
TCTGTAATGCG -> CTGTAATGCGG
TCTGTCTAAGA -> CTGTCTAAGAA
TCTTAAAGGTA -> CTTAAAGGTAT
TCTTAAATCGT -> CTTAAATCGTA
TCTTCCACGCC -> CTTCCACGCCC
TCTTGAAGAGC -> CTTGAAGAGCA
TCTTGAATACA -> CTTGAATACAC
TCTTGCAGGGT -> CTTGCAGGGTA
TCTTGGATCCC -> CTTGGATCCCG
TCTTGGGTCAT -> CTTGGGTCATC
TCTTTATAGTA -> CTTTATAGTAA
TCTTTGTATCC -> CTTTGTATCCT
TGAAACTATCC -> GAAACTATCCT
TGAAAGCTCCC -> GAAAGCTCCCC
TGAACCAGGTA -> GAACCAGGTAC
TGAACTCATAA -> GAACTCATAAG
TGAAGAGCACC -> GAAGAGCACCA
TGAAGCGTAAG -> GAAGCGTAAGG
TGAATACACAC -> GAATACACACT
TGAATCACGGC -> GAATCACGGCG
TGACATCCTCA -> GACATCCTCAA
TGACCATAACA -> GACCATAACAG
TGACTAGATGT -> GACTAGATGTT
TGACTGAGGTG -> GACTGAGGTGA
TGACTTTGGCC -> GACTTTGGCCG
TGAGAAGACTC -> GAGAAGACTCA
TGAGACGTGGC -> GAGACGTGGCT
TGAGACTACGT -> GAGACTACGTT
TGAGAGACCAA -> GAGAGACCAAA
TGAGCCTCATG -> GAGCCTCATGC
TGAGGAATAAT -> GAGGAATAATA
TGAGGGTCGTA -> GAGGGTCGTAG
TGAGGTGAGAC -> GAGGTGAGACT
TGATAACCACC -> GATAACCACCT
TGATCGTAAGC -> GATCGTAAGCG
TGATGCCGTTT -> GATGCCGTTTC
TGATGTATACT -> GATGTATACTG
TGATGTTTCCG -> GATGTTTCCGG
TGATTAACGCC -> GATTAACGCCG
TGATTACCCAT -> GATTACCCATG
TGATTACTGCC -> GATTACTGCCC
TGCACAGCAAC -> GCACAGCAACA
TGCACCCTTTG -> GCACCCTTTGA
TGCAGGGTAGC -> GCAGGGTAGCG
TGCATCTTGGA -> GCATCTTGGAT
TGCATGCTTCG -> GCATGCTTCGC
TGCCACGCAGT -> GCCACGCAGTA
TGCCAGTGCCG -> GCCAGTGCCGT
TGCCCAGACAC -> GCCCAGACACG
TGCCCAGTTTT -> GCCCAGTTTTG
TGCCCTGGCTC -> GCCCTGGCTCA
TGCCGTTAAGC -> GCCGTTAAGCA
TGCCGTTACAT -> GCCGTTACATG
TGCCGTTTCGC -> GCCGTTTCGCT
TGCGAATACCA -> GCGAATACCAG
TGCGGCGGACG -> GCGGCGGACGA
TGCGGGGCATA -> GCGGGGCATAT
TGCGGTGGTGG -> GCGGTGGTGGT
TGCGTCGGCAG -> GCGTCGGCAGG
TGCGTTACCTA -> GCGTTACCTAG
TGCGTTATTAG -> GCGTTATTAGG
TGCTAATCATA -> GCTAATCATAT
TGCTAGAAGTG -> GCTAGAAGTGC
TGCTAGGCATA -> GCTAGGCATAC
TGCTATTCAGA -> GCTATTCAGAA
TGCTCCCCCCG -> GCTCCCCCCGA
TGCTCTTAAAT -> GCTCTTAAATC
TGCTTCGCTGA -> GCTTCGCTGAG
TGCTTTATCCG -> GCTTTATCCGG
TGGAACGTGCC -> GGAACGTGCCA
TGGACCTTTAA -> GGACCTTTAAT
TGGACGATAGC -> GGACGATAGCT
TGGACGCCAAG -> GGACGCCAAGC
TGGACGGTGAA -> GGACGGTGAAA
TGGAGAGCAAA -> GGAGAGCAAAG
TGGATCCCGAG -> GGATCCCGAGA
TGGATGTGCGT -> GGATGTGCGTT
TGGCCCTAATT -> GGCCCTAATTT
TGGCCGCGCGA -> GGCCGCGCGAC
TGGCCGGTAGG -> GGCCGGTAGGG
TGGCGAAATAA -> GGCGAAATAAC
TGGCGGTTAAC -> GGCGGTTAACT
TGGCGTGGTTC -> GGCGTGGTTCA
TGGCTCAATAT -> GGCTCAATATA
TGGCTCACGTG -> GGCTCACGTGC
TGGCTTGGCGT -> GGCTTGGCGTG
TGGGAAAAAAG -> GGGAAAAAAGG
TGGGGAGGATT -> GGGGAGGATTC
TGGGGTTAGGC -> GGGGTTAGGCG
TGGGTCATCCC -> GGGTCATCCCG
TGGGTCGCCAG -> GGGTCGCCAGC
TGGTCGACGAC -> GGTCGACGACG
TGGTCGGTCAC -> GGTCGGTCACC
TGGTCTTGAAG -> GGTCTTGAAGA
TGGTGCCCAGA -> GGTGCCCAGAC
TGGTGGTCGAC -> GGTGGTCGACG
TGGTGTTAATC -> GGTGTTAATCA
TGGTTCATGAT -> GGTTCATGATG
TGGTTCATTCT -> GGTTCATTCTC
TGGTTCTTGAA -> GGTTCTTGAAT
TGGTTTATGCG -> GGTTTATGCGG
TGTAACATTAC -> GTAACATTACC
TGTAATGCGGT -> GTAATGCGGTG
TGTACAAGCCG -> GTACAAGCCGG
TGTACGACGTC -> GTACGACGTCC
TGTAGTCCATC -> GTAGTCCATCT
TGTATACTGAA -> GTATACTGAAC
TGTATCCTGTA -> GTATCCTGTAA
TGTATCGGAAG -> GTATCGGAAGT
TGTCAACTCCT -> GTCAACTCCTC
TGTCCATGCGA -> GTCCATGCGAA
TGTCCTACGAC -> GTCCTACGACG
TGTCTAAGAAT -> GTCTAAGAATG
TGTCTGCTCCC -> GTCTGCTCCCC
TGTGCGTTACC -> GTGCGTTACCT
TGTTAATCAGC -> GTTAATCAGCC
TGTTCAGCTTG -> GTTCAGCTTGT
TGTTCGCCGTG -> GTTCGCCGTGC
TGTTCTGATCG -> GTTCTGATCGT
TGTTTCCGGCC -> GTTTCCGGCCT
TGTTTTAGACG -> GTTTTAGACGT
TTAAAAATGCA -> TAAAAATGCAT
TTAAAGGTATA -> TAAAGGTATAT
TTAAATCGTAA -> TAAATCGTAAA
TTAACGCCGGG -> TAACGCCGGGT
TTAACTCACCA -> TAACTCACCAC
TTAACTGGTTC -> TAACTGGTTCA
TTAAGCACTCA -> TAAGCACTCAC
TTAAGTAAGGG -> TAAGTAAGGGA
TTAAGTGCGTT -> TAAGTGCGTTA
TTAATATCTTT -> TAATATCTTTA
TTAATCAGCCA -> TAATCAGCCAC
TTAATTAACTG -> TAATTAACTGG
TTACATGTACG -> TACATGTACGA
TTACCATACCT -> TACCATACCTC
TTACCCACGGT -> TACCCACGGTC
TTACCCATGGA -> TACCCATGGAA
TTACCTAGTCA -> TACCTAGTCAG
TTACCTGCCGT -> TACCTGCCGTT
TTACTGCCCAG -> TACTGCCCAGT
TTAGACGTCAA -> TAGACGTCAAC
TTAGCGGACTA -> TAGCGGACTAA
TTAGGTATTCA -> TAGGTATTCAA
TTAGTACGGCA -> TAGTACGGCAG
TTAGTCAGTCA -> TAGTCAGTCAA
TTATAGTAAAA -> TATAGTAAAAG
TTATCCGGTCC -> TATCCGGTCCC
TTATGCGGCGG -> TATGCGGCGGA
TTATGGCGGTT -> TATGGCGGTTA
TTATTAGGTAT -> TATTAGGTATT
TTCAAACCGTG -> TCAAACCGTGA
TTCAAAGCTAT -> TCAAAGCTATG
TTCAAGCCACT -> TCAAGCCACTT
TTCACTTGCTA -> TCACTTGCTAG
TTCAGAAAACG -> TCAGAAAACGT
TTCAGATGTAT -> TCAGATGTATC
TTCAGCTTAAT -> TCAGCTTAATA
TTCAGCTTGTC -> TCAGCTTGTCC
TTCAGGAGGCT -> TCAGGAGGCTG
TTCATGATGTA -> TCATGATGTAT
TTCATTCTCAG -> TCATTCTCAGT
TTCATTGGTGC -> TCATTGGTGCC
TTCCACGCCCG -> TCCACGCCCGA
TTCCCAACCAG -> TCCCAACCAGC
TTCCGGCCTGC -> TCCGGCCTGCT
TTCCGTCAGGG -> TCCGTCAGGGC
TTCCGTCGTGC -> TCCGTCGTGCT
TTCCTGGGTCG -> TCCTGGGTCGC
TTCCTTCGACC -> TCCTTCGACCC
TTCGACCCCGT -> TCGACCCCGTC
TTCGATCTGTA -> TCGATCTGTAA
TTCGCAATATC -> TCGCAATATCT
TTCGCAGCGAG -> TCGCAGCGAGT
TTCGCATATAA -> TCGCATATAAC
TTCGCCGTGCT -> TCGCCGTGCTT
TTCGCTCGGAA -> TCGCTCGGAAT
TTCGCTGAGGG -> TCGCTGAGGGT
TTCGGGTATCC -> TCGGGTATCCC
TTCGTTGTTCA -> TCGTTGTTCAG
TTCTCAGCATA -> TCTCAGCATAT
TTCTCAGTTGT -> TCTCAGTTGTC
TTCTGATCGTA -> TCTGATCGTAA
TTCTGATGCCG -> TCTGATGCCGT
TTCTGTCTAAG -> TCTGTCTAAGA
TTCTTAAAGGT -> TCTTAAAGGTA
TTCTTCCACGC -> TCTTCCACGCC
TTCTTGAATAC -> TCTTGAATACA
TTGAACCAGGT -> TGAACCAGGTA
TTGAAGAGCAC -> TGAAGAGCACC
TTGAAGCGTAA -> TGAAGCGTAAG
TTGAATACACA -> TGAATACACAC
TTGAATCACGG -> TGAATCACGGC
TTGACTGAGGT -> TGACTGAGGTG
TTGAGAGACCA -> TGAGAGACCAA
TTGATTACCCA -> TGATTACCCAT
TTGCAGGGTAG -> TGCAGGGTAGC
TTGCCACGCAG -> TGCCACGCAGT
TTGCTAGAAGT -> TGCTAGAAGTG
TTGGACGATAG -> TGGACGATAGC
TTGGATCCCGA -> TGGATCCCGAG
TTGGCCCTAAT -> TGGCCCTAATT
TTGGCCGCGCG -> TGGCCGCGCGA
TTGGCGTGGTT -> TGGCGTGGTTC
TTGGGAAAAAA -> TGGGAAAAAAG
TTGGGTCATCC -> TGGGTCATCCC
TTGGTCTTGAA -> TGGTCTTGAAG
TTGGTGCCCAG -> TGGTGCCCAGA
TTGGTGTTAAT -> TGGTGTTAATC
TTGTACAAGCC -> TGTACAAGCCG
TTGTATCCTGT -> TGTATCCTGTA
TTGTCAACTCC -> TGTCAACTCCT
TTGTCCTACGA -> TGTCCTACGAC
TTGTTCAGCTT -> TGTTCAGCTTG
TTTAAAAATGC -> TTAAAAATGCA
TTTAAGTAAGG -> TTAAGTAAGGG
TTTAATTAACT -> TTAATTAACTG
TTTAGACGTCA -> TTAGACGTCAA
TTTAGTACGGC -> TTAGTACGGCA
TTTATAGTAAA -> TTATAGTAAAA
TTTATCCGGTC -> TTATCCGGTCC
TTTATGCGGCG -> TTATGCGGCGG
TTTCCGGCCTG -> TTCCGGCCTGC
TTTCGCAATAT -> TTCGCAATATC
TTTCGCTCGGA -> TTCGCTCGGAA
TTTCGGGTATC -> TTCGGGTATCC
TTTGAACCAGG -> TTGAACCAGGT
TTTGACTGAGG -> TTGACTGAGGT
TTTGCCACGCA -> TTGCCACGCAG
TTTGGCCGCGC -> TTGGCCGCGCG
TTTGGTGTTAA -> TTGGTGTTAAT
TTTGTATCCTG -> TTGTATCCTGT
TTTTAAAAATG -> TTTAAAAATGC
TTTTAAGTAAG -> TTTAAGTAAGG
TTTTAGACGTC -> TTTAGACGTCA
TTTTGCCACGC -> TTTGCCACGCA
