AAAAAATTGTGTACATGTTG -> AAAAATTGTGTACATGTTGC
AAAAATTGTGTACATGTTGC -> AAAATTGTGTACATGTTGCG
AAAATTGTGTACATGTTGCG -> AAATTGTGTACATGTTGCGA
AAACGTCAATAGTTTCGAGG -> AACGTCAATAGTTTCGAGGA
AAACGTCCGGCCGACTCTCA -> AACGTCCGGCCGACTCTCAT
AAAGAGGCTGCTATCGTGAT -> AAGAGGCTGCTATCGTGATT
AAATTGTGTACATGTTGCGA -> AATTGTGTACATGTTGCGAC
AACAAAAAATTGTGTACATG -> ACAAAAAATTGTGTACATGT
AACAGTGAATCCCGGAGCCC -> ACAGTGAATCCCGGAGCCCA
AACATGACGCCGCGCAAGAA -> ACATGACGCCGCGCAAGAAG
AACCATGTCTACTACTTCCT -> ACCATGTCTACTACTTCCTT
AACCGGATTCGGGTTCTAAG -> ACCGGATTCGGGTTCTAAGG
AACCGGCTGGTCCTGCATGA -> ACCGGCTGGTCCTGCATGAG
AACCTCGCCCGCGTCGGTCG -> ACCTCGCCCGCGTCGGTCGT
AACGTCAATAGTTTCGAGGA -> ACGTCAATAGTTTCGAGGAT
AACGTCCGGCCGACTCTCAT -> ACGTCCGGCCGACTCTCATG
AACTACTACCTGTGACATAC -> ACTACTACCTGTGACATACA
AACTATCCTCTACGTGGGGT -> ACTATCCTCTACGTGGGGTG
AAGAAGGTATTTTGGTGGCA -> AGAAGGTATTTTGGTGGCAT
AAGACCCCACGAAGAGACGT -> AGACCCCACGAAGAGACGTC
AAGAGACGTCGTTAGCGCCT -> AGAGACGTCGTTAGCGCCTC
AAGAGGCTGCTATCGTGATT -> AGAGGCTGCTATCGTGATTC
AAGCATTGCACGGTGTGTCT -> AGCATTGCACGGTGTGTCTT
AAGCTTAGGGTCGCTCGTCC -> AGCTTAGGGTCGCTCGTCCT
AAGGCAGCGTAGCGGGGAAA -> AGGCAGCGTAGCGGGGAAAG
AAGGGCGCGCGAATTTCTTC -> AGGGCGCGCGAATTTCTTCA
AAGGGCTCAAGACCCCACGA -> AGGGCTCAAGACCCCACGAA
AAGGTATTTTGGTGGCATCT -> AGGTATTTTGGTGGCATCTA
AAGGTTCCTGTTCGTTTTAA -> AGGTTCCTGTTCGTTTTAAC
AAGTCACCGGATGGTCGTTC -> AGTCACCGGATGGTCGTTCA
AAGTCACTCTATTTCATGTA -> AGTCACTCTATTTCATGTAA
AAGTTTAGCTCCGACTACCG -> AGTTTAGCTCCGACTACCGG
AATAGTTTCGAGGATCCGGC -> ATAGTTTCGAGGATCCGGCA
AATCCCGGAGCCCACCATTC -> ATCCCGGAGCCCACCATTCC
AATCGCTGTCGTGGCCGGAG -> ATCGCTGTCGTGGCCGGAGC
AATGCCCAATTTACGCGCTC -> ATGCCCAATTTACGCGCTCG
AATTCATGCCGGTAAGCATT -> ATTCATGCCGGTAAGCATTG
AATTGTGTACATGTTGCGAC -> ATTGTGTACATGTTGCGACC
AATTTACGCGCTCGGGACCG -> ATTTACGCGCTCGGGACCGT
AATTTCTTCATTGAAACCGC -> ATTTCTTCATTGAAACCGCG
AATTTGCCGGGCTGCATCCC -> ATTTGCCGGGCTGCATCCCG
ACAAAAAATTGTGTACATGT -> CAAAAAATTGTGTACATGTT
ACAAGTCACTCTATTTCATG -> CAAGTCACTCTATTTCATGT
ACACCCAGAGCACAGGTATA -> CACCCAGAGCACAGGTATAG
ACACGGTTTCACGTTTTCTC -> CACGGTTTCACGTTTTCTCA
ACAGGTATAGAGCATAGGTA -> CAGGTATAGAGCATAGGTAC
ACAGTGAATCCCGGAGCCCA -> CAGTGAATCCCGGAGCCCAC
ACATAAACGTCCGGCCGACT -> CATAAACGTCCGGCCGACTC
ACATACATCAGGCCCCCTGG -> CATACATCAGGCCCCCTGGT
ACATCAGGCCCCCTGGTGTC -> CATCAGGCCCCCTGGTGTCA
ACATGACGCCGCGCAAGAAG -> CATGACGCCGCGCAAGAAGG
ACATGCACTTTCTTACTAAG -> CATGCACTTTCTTACTAAGT
ACATGTTGCGACCAGTATAC -> CATGTTGCGACCAGTATACG
ACCAGTATACGAGTGCCGAC -> CCAGTATACGAGTGCCGACT
ACCAGTGTAACCGGCTGGTC -> CCAGTGTAACCGGCTGGTCC
ACCATGTCTACTACTTCCTT -> CCATGTCTACTACTTCCTTC
ACCATTCCCATTCTGTAATG -> CCATTCCCATTCTGTAATGC
ACCCAGAGCACAGGTATAGA -> CCCAGAGCACAGGTATAGAG
ACCCCACGAAGAGACGTCGT -> CCCCACGAAGAGACGTCGTT
ACCCTGGCGCTCCGCGATAA -> CCCTGGCGCTCCGCGATAAC
ACCGGATGGTCGTTCAGTGA -> CCGGATGGTCGTTCAGTGAT
ACCGGATTCGGGTTCTAAGG -> CCGGATTCGGGTTCTAAGGT
ACCGGCACTGTGATGTGCCC -> CCGGCACTGTGATGTGCCCT
ACCGGCTGGTCCTGCATGAG -> CCGGCTGGTCCTGCATGAGT
ACCGGTAAACGTCAATAGTT -> CCGGTAAACGTCAATAGTTT
ACCGTGTCGGGAGGGACCAG -> CCGTGTCGGGAGGGACCAGT
ACCTACATAAACGTCCGGCC -> CCTACATAAACGTCCGGCCG
ACCTCGCCCGCGTCGGTCGT -> CCTCGCCCGCGTCGGTCGTC
ACCTGTGACATACATCAGGC -> CCTGTGACATACATCAGGCC
ACGAAGAGACGTCGTTAGCG -> CGAAGAGACGTCGTTAGCGC
ACGAGTGCCGACTTCCACTA -> CGAGTGCCGACTTCCACTAC
ACGATTAGACCTACATAAAC -> CGATTAGACCTACATAAACG
ACGCCGCGCAAGAAGGTATT -> CGCCGCGCAAGAAGGTATTT
ACGCGCTCGGGACCGTGTCG -> CGCGCTCGGGACCGTGTCGG
ACGGGCCCGTGGACACGGTT -> CGGGCCCGTGGACACGGTTT
ACGGTACACCCAGAGCACAG -> CGGTACACCCAGAGCACAGG
ACGGTGTGTCTTACGTCGTT -> CGGTGTGTCTTACGTCGTTT
ACGGTTTCACGTTTTCTCAG -> CGGTTTCACGTTTTCTCAGG
ACGTCAATAGTTTCGAGGAT -> CGTCAATAGTTTCGAGGATC
ACGTCCGGCCGACTCTCATG -> CGTCCGGCCGACTCTCATGC
ACGTCGATCTGGGGAGTCCC -> CGTCGATCTGGGGAGTCCCT
ACGTCGTTAGCGCCTCCGAC -> CGTCGTTAGCGCCTCCGACA
ACGTCGTTTAAGTTTAGCTC -> CGTCGTTTAAGTTTAGCTCC
ACGTGGGGTGTCGGCCGAAC -> CGTGGGGTGTCGGCCGAACC
ACGTTTTCTCAGGTTATTTG -> CGTTTTCTCAGGTTATTTGC
ACTAAGTCACCGGATGGTCG -> CTAAGTCACCGGATGGTCGT
ACTACCGGCACTGTGATGTG -> CTACCGGCACTGTGATGTGC
ACTACCTGTGACATACATCA -> CTACCTGTGACATACATCAG
ACTACTACCTGTGACATACA -> CTACTACCTGTGACATACAT
ACTACTCCGTCTCCGGGGCA -> CTACTCCGTCTCCGGGGCAG
ACTACTTCCTTCAAGGGCTC -> CTACTTCCTTCAAGGGCTCA
ACTATCCTCTACGTGGGGTG -> CTATCCTCTACGTGGGGTGT
ACTCCGTCTCCGGGGCAGTC -> CTCCGTCTCCGGGGCAGTCA
ACTCTATTTCATGTAACAAA -> CTCTATTTCATGTAACAAAA
ACTCTCATGCGTGCGATGCG -> CTCTCATGCGTGCGATGCGG
ACTGTGATGTGCCCTAACTA -> CTGTGATGTGCCCTAACTAC
ACTTCCACTACTCCGTCTCC -> CTTCCACTACTCCGTCTCCG
ACTTCCTTCAAGGGCTCAAG -> CTTCCTTCAAGGGCTCAAGA
ACTTTCTTACTAAGTCACCG -> CTTTCTTACTAAGTCACCGG
AGAAGGCAGCGTAGCGGGGA -> GAAGGCAGCGTAGCGGGGAA
AGAAGGTATTTTGGTGGCAT -> GAAGGTATTTTGGTGGCATC
AGAATTCATGCCGGTAAGCA -> GAATTCATGCCGGTAAGCAT
AGAATTTGCCGGGCTGCATC -> GAATTTGCCGGGCTGCATCC
AGACCCCACGAAGAGACGTC -> GACCCCACGAAGAGACGTCG
AGACCTACATAAACGTCCGG -> GACCTACATAAACGTCCGGC
AGACGTCGTTAGCGCCTCCG -> GACGTCGTTAGCGCCTCCGA
AGAGACGTCGTTAGCGCCTC -> GAGACGTCGTTAGCGCCTCC
AGAGCACAGGTATAGAGCAT -> GAGCACAGGTATAGAGCATA
AGAGCATAGGTACGTCGATC -> GAGCATAGGTACGTCGATCT
AGAGCCCTAGGTGAACATGA -> GAGCCCTAGGTGAACATGAC
AGAGGCGCACGGGCCCGTGG -> GAGGCGCACGGGCCCGTGGA
AGAGGCTGCTATCGTGATTC -> GAGGCTGCTATCGTGATTCT
AGATCTCTATCGGCGCCTCC -> GATCTCTATCGGCGCCTCCA
AGCACAGGTATAGAGCATAG -> GCACAGGTATAGAGCATAGG
AGCATAGGTACGTCGATCTG -> GCATAGGTACGTCGATCTGG
AGCATTGCACGGTGTGTCTT -> GCATTGCACGGTGTGTCTTA
AGCCCACCATTCCCATTCTG -> GCCCACCATTCCCATTCTGT
AGCCCTAGGTGAACATGACG -> GCCCTAGGTGAACATGACGC
AGCGAGAGCCCTAGGTGAAC -> GCGAGAGCCCTAGGTGAACA
AGCGCCTCCGACATGCACTT -> GCGCCTCCGACATGCACTTT
AGCGGGGAAAGAGGCTGCTA -> GCGGGGAAAGAGGCTGCTAT
AGCGTAGCGGGGAAAGAGGC -> GCGTAGCGGGGAAAGAGGCT
AGCTCCGACTACCGGCACTG -> GCTCCGACTACCGGCACTGT
AGCTGTCTAGCGAGAGCCCT -> GCTGTCTAGCGAGAGCCCTA
AGCTTAGGGTCGCTCGTCCT -> GCTTAGGGTCGCTCGTCCTG
AGCTTTTAGATCTCTATCGG -> GCTTTTAGATCTCTATCGGC
AGGATCCGGCACAAGTCACT -> GGATCCGGCACAAGTCACTC
AGGCAGCGTAGCGGGGAAAG -> GGCAGCGTAGCGGGGAAAGA
AGGCCCCCTGGTGTCAGAAG -> GGCCCCCTGGTGTCAGAAGG
AGGCGCACGGGCCCGTGGAC -> GGCGCACGGGCCCGTGGACA
AGGCTGCTATCGTGATTCTA -> GGCTGCTATCGTGATTCTAC
AGGGACCAGTGTAACCGGCT -> GGGACCAGTGTAACCGGCTG
AGGGCGCGCGAATTTCTTCA -> GGGCGCGCGAATTTCTTCAT
AGGGCTCAAGACCCCACGAA -> GGGCTCAAGACCCCACGAAG
AGGGTCGCTCGTCCTGGGGG -> GGGTCGCTCGTCCTGGGGGC
AGGTACGTCGATCTGGGGAG -> GGTACGTCGATCTGGGGAGT
AGGTATAGAGCATAGGTACG -> GGTATAGAGCATAGGTACGT
AGGTATTTTGGTGGCATCTA -> GGTATTTTGGTGGCATCTAT
AGGTGAACATGACGCCGCGC -> GGTGAACATGACGCCGCGCA
AGGTTATTTGCCCAAGGGCG -> GGTTATTTGCCCAAGGGCGC
AGGTTCCTGTTCGTTTTAAC -> GGTTCCTGTTCGTTTTAACC
AGTAACCTCGCCCGCGTCGG -> GTAACCTCGCCCGCGTCGGT
AGTATACGAGTGCCGACTTC -> GTATACGAGTGCCGACTTCC
AGTCACCGGATGGTCGTTCA -> GTCACCGGATGGTCGTTCAG
AGTCACTCTATTTCATGTAA -> GTCACTCTATTTCATGTAAC
AGTCATACGGTACACCCAGA -> GTCATACGGTACACCCAGAG
AGTCATTAATCGCTGTCGTG -> GTCATTAATCGCTGTCGTGG
AGTCCCTAGAGGCGCACGGG -> GTCCCTAGAGGCGCACGGGC
AGTGAATCCCGGAGCCCACC -> GTGAATCCCGGAGCCCACCA
AGTGATAACAGTGAATCCCG -> GTGATAACAGTGAATCCCGG
AGTGCCGACTTCCACTACTC -> GTGCCGACTTCCACTACTCC
AGTGTAACCGGCTGGTCCTG -> GTGTAACCGGCTGGTCCTGC
AGTTAGCTTTTAGATCTCTA -> GTTAGCTTTTAGATCTCTAT
AGTTTAGCTCCGACTACCGG -> GTTTAGCTCCGACTACCGGC
AGTTTCGAGGATCCGGCACA -> GTTTCGAGGATCCGGCACAA
ATAAACGTCCGGCCGACTCT -> TAAACGTCCGGCCGACTCTC
ATAACAGTGAATCCCGGAGC -> TAACAGTGAATCCCGGAGCC
ATAACTATCCTCTACGTGGG -> TAACTATCCTCTACGTGGGG
ATACATCAGGCCCCCTGGTG -> TACATCAGGCCCCCTGGTGT
ATACCGGTAAACGTCAATAG -> TACCGGTAAACGTCAATAGT
ATACGAGTGCCGACTTCCAC -> TACGAGTGCCGACTTCCACT
ATACGGTACACCCAGAGCAC -> TACGGTACACCCAGAGCACA
ATAGAGCATAGGTACGTCGA -> TAGAGCATAGGTACGTCGAT
ATAGGTACGTCGATCTGGGG -> TAGGTACGTCGATCTGGGGA
ATAGTAACCTCGCCCGCGTC -> TAGTAACCTCGCCCGCGTCG
ATAGTTTCGAGGATCCGGCA -> TAGTTTCGAGGATCCGGCAC
ATCAGAATTCATGCCGGTAA -> TCAGAATTCATGCCGGTAAG
ATCAGGCCCCCTGGTGTCAG -> TCAGGCCCCCTGGTGTCAGA
ATCCCGATCAGAATTCATGC -> TCCCGATCAGAATTCATGCC
ATCCCGGAGCCCACCATTCC -> TCCCGGAGCCCACCATTCCC
ATCCGGCACAAGTCACTCTA -> TCCGGCACAAGTCACTCTAT
ATCCTCTACGTGGGGTGTCG -> TCCTCTACGTGGGGTGTCGG
ATCGCTGTCGTGGCCGGAGC -> TCGCTGTCGTGGCCGGAGCT
ATCGGCGCCTCCAAGCTTAG -> TCGGCGCCTCCAAGCTTAGG
ATCGTGATTCTACCCTGGCG -> TCGTGATTCTACCCTGGCGC
ATCTATAGTAACCTCGCCCG -> TCTATAGTAACCTCGCCCGC
ATCTCTATCGGCGCCTCCAA -> TCTCTATCGGCGCCTCCAAG
ATCTGGGGAGTCCCTAGAGG -> TCTGGGGAGTCCCTAGAGGC
ATCTGGTGTCATGCAGTCAT -> TCTGGTGTCATGCAGTCATT
ATGACGCCGCGCAAGAAGGT -> TGACGCCGCGCAAGAAGGTA
ATGAGAATTTGCCGGGCTGC -> TGAGAATTTGCCGGGCTGCA
ATGAGTTAGCTTTTAGATCT -> TGAGTTAGCTTTTAGATCTC
ATGCACTTTCTTACTAAGTC -> TGCACTTTCTTACTAAGTCA
ATGCAGTCATTAATCGCTGT -> TGCAGTCATTAATCGCTGTC
ATGCCCAATTTACGCGCTCG -> TGCCCAATTTACGCGCTCGG
ATGCCGGTAAGCATTGCACG -> TGCCGGTAAGCATTGCACGG
ATGCGGGGATCTGGTGTCAT -> TGCGGGGATCTGGTGTCATG
ATGCGTGCGATGCGGGGATC -> TGCGTGCGATGCGGGGATCT
ATGGTCGTTCAGTGATAACA -> TGGTCGTTCAGTGATAACAG
ATGTAACAAAAAATTGTGTA -> TGTAACAAAAAATTGTGTAC
ATGTCTACTACTTCCTTCAA -> TGTCTACTACTTCCTTCAAG
ATGTGCCCTAACTACTACCT -> TGTGCCCTAACTACTACCTG
ATGTTGCGACCAGTATACGA -> TGTTGCGACCAGTATACGAG
ATTAATCGCTGTCGTGGCCG -> TTAATCGCTGTCGTGGCCGG
ATTAGACCTACATAAACGTC -> TTAGACCTACATAAACGTCC
ATTCATGCCGGTAAGCATTG -> TTCATGCCGGTAAGCATTGC
ATTCCCATTCTGTAATGCCC -> TTCCCATTCTGTAATGCCCA
ATTCGGGTTCTAAGGTTCCT -> TTCGGGTTCTAAGGTTCCTG
ATTCTACCCTGGCGCTCCGC -> TTCTACCCTGGCGCTCCGCG
ATTCTGTAATGCCCAATTTA -> TTCTGTAATGCCCAATTTAC
ATTGCACGGTGTGTCTTACG -> TTGCACGGTGTGTCTTACGT
ATTGTGTACATGTTGCGACC -> TTGTGTACATGTTGCGACCA
ATTTACGCGCTCGGGACCGT -> TTTACGCGCTCGGGACCGTG
ATTTCATGTAACAAAAAATT -> TTTCATGTAACAAAAAATTG
ATTTCTTCATTGAAACCGCG -> TTTCTTCATTGAAACCGCGT
ATTTGCCCAAGGGCGCGCGA -> TTTGCCCAAGGGCGCGCGAA
ATTTGCCGGGCTGCATCCCG -> TTTGCCGGGCTGCATCCCGA
ATTTTGGTGGCATCTATAGT -> TTTTGGTGGCATCTATAGTA
CAAAAAATTGTGTACATGTT -> AAAAAATTGTGTACATGTTG
CAAGAAGGTATTTTGGTGGC -> AAGAAGGTATTTTGGTGGCA
CAAGACCCCACGAAGAGACG -> AAGACCCCACGAAGAGACGT
CAAGCTTAGGGTCGCTCGTC -> AAGCTTAGGGTCGCTCGTCC
CAAGGGCGCGCGAATTTCTT -> AAGGGCGCGCGAATTTCTTC
CAAGGGCTCAAGACCCCACG -> AAGGGCTCAAGACCCCACGA
CAAGTCACTCTATTTCATGT -> AAGTCACTCTATTTCATGTA
CAATAGTTTCGAGGATCCGG -> AATAGTTTCGAGGATCCGGC
CAATTTACGCGCTCGGGACC -> AATTTACGCGCTCGGGACCG
CACAAGTCACTCTATTTCAT -> ACAAGTCACTCTATTTCATG
CACAGGTATAGAGCATAGGT -> ACAGGTATAGAGCATAGGTA
CACCATTCCCATTCTGTAAT -> ACCATTCCCATTCTGTAATG
CACCCAGAGCACAGGTATAG -> ACCCAGAGCACAGGTATAGA
CACCGGATGGTCGTTCAGTG -> ACCGGATGGTCGTTCAGTGA
CACGAAGAGACGTCGTTAGC -> ACGAAGAGACGTCGTTAGCG
CACGGGCCCGTGGACACGGT -> ACGGGCCCGTGGACACGGTT
CACGGTGTGTCTTACGTCGT -> ACGGTGTGTCTTACGTCGTT
CACGGTTTCACGTTTTCTCA -> ACGGTTTCACGTTTTCTCAG
CACGTTTTCTCAGGTTATTT -> ACGTTTTCTCAGGTTATTTG
CACTACTCCGTCTCCGGGGC -> ACTACTCCGTCTCCGGGGCA
CACTCTATTTCATGTAACAA -> ACTCTATTTCATGTAACAAA
CACTGTGATGTGCCCTAACT -> ACTGTGATGTGCCCTAACTA
CACTTTCTTACTAAGTCACC -> ACTTTCTTACTAAGTCACCG
CAGAAGGCAGCGTAGCGGGG -> AGAAGGCAGCGTAGCGGGGA
CAGAATTCATGCCGGTAAGC -> AGAATTCATGCCGGTAAGCA
CAGAGCACAGGTATAGAGCA -> AGAGCACAGGTATAGAGCAT
CAGCGTAGCGGGGAAAGAGG -> AGCGTAGCGGGGAAAGAGGC
CAGGCCCCCTGGTGTCAGAA -> AGGCCCCCTGGTGTCAGAAG
CAGGTATAGAGCATAGGTAC -> AGGTATAGAGCATAGGTACG
CAGGTTATTTGCCCAAGGGC -> AGGTTATTTGCCCAAGGGCG
CAGTATACGAGTGCCGACTT -> AGTATACGAGTGCCGACTTC
CAGTCATACGGTACACCCAG -> AGTCATACGGTACACCCAGA
CAGTCATTAATCGCTGTCGT -> AGTCATTAATCGCTGTCGTG
CAGTGAATCCCGGAGCCCAC -> AGTGAATCCCGGAGCCCACC
CAGTGATAACAGTGAATCCC -> AGTGATAACAGTGAATCCCG
CAGTGTAACCGGCTGGTCCT -> AGTGTAACCGGCTGGTCCTG
CATAAACGTCCGGCCGACTC -> ATAAACGTCCGGCCGACTCT
CATACATCAGGCCCCCTGGT -> ATACATCAGGCCCCCTGGTG
CATACCGGTAAACGTCAATA -> ATACCGGTAAACGTCAATAG
CATACGGTACACCCAGAGCA -> ATACGGTACACCCAGAGCAC
CATAGGTACGTCGATCTGGG -> ATAGGTACGTCGATCTGGGG
CATCAGGCCCCCTGGTGTCA -> ATCAGGCCCCCTGGTGTCAG
CATCCCGATCAGAATTCATG -> ATCCCGATCAGAATTCATGC
CATCTATAGTAACCTCGCCC -> ATCTATAGTAACCTCGCCCG
CATGACGCCGCGCAAGAAGG -> ATGACGCCGCGCAAGAAGGT
CATGAGTTAGCTTTTAGATC -> ATGAGTTAGCTTTTAGATCT
CATGCACTTTCTTACTAAGT -> ATGCACTTTCTTACTAAGTC
CATGCAGTCATTAATCGCTG -> ATGCAGTCATTAATCGCTGT
CATGCCGGTAAGCATTGCAC -> ATGCCGGTAAGCATTGCACG
CATGCGTGCGATGCGGGGAT -> ATGCGTGCGATGCGGGGATC
CATGTAACAAAAAATTGTGT -> ATGTAACAAAAAATTGTGTA
CATGTCTACTACTTCCTTCA -> ATGTCTACTACTTCCTTCAA
CATGTTGCGACCAGTATACG -> ATGTTGCGACCAGTATACGA
CATTAATCGCTGTCGTGGCC -> ATTAATCGCTGTCGTGGCCG
CATTCCCATTCTGTAATGCC -> ATTCCCATTCTGTAATGCCC
CATTCTGTAATGCCCAATTT -> ATTCTGTAATGCCCAATTTA
CATTGCACGGTGTGTCTTAC -> ATTGCACGGTGTGTCTTACG
CCAAGCTTAGGGTCGCTCGT -> CAAGCTTAGGGTCGCTCGTC
CCAAGGGCGCGCGAATTTCT -> CAAGGGCGCGCGAATTTCTT
CCAATTTACGCGCTCGGGAC -> CAATTTACGCGCTCGGGACC
CCACCATTCCCATTCTGTAA -> CACCATTCCCATTCTGTAAT
CCACGAAGAGACGTCGTTAG -> CACGAAGAGACGTCGTTAGC
CCACTACTCCGTCTCCGGGG -> CACTACTCCGTCTCCGGGGC
CCAGAGCACAGGTATAGAGC -> CAGAGCACAGGTATAGAGCA
CCAGTATACGAGTGCCGACT -> CAGTATACGAGTGCCGACTT
CCAGTGTAACCGGCTGGTCC -> CAGTGTAACCGGCTGGTCCT
CCATGTCTACTACTTCCTTC -> CATGTCTACTACTTCCTTCA
CCATTCCCATTCTGTAATGC -> CATTCCCATTCTGTAATGCC
CCATTCTGTAATGCCCAATT -> CATTCTGTAATGCCCAATTT
CCCAAGGGCGCGCGAATTTC -> CCAAGGGCGCGCGAATTTCT
CCCAATTTACGCGCTCGGGA -> CCAATTTACGCGCTCGGGAC
CCCACCATTCCCATTCTGTA -> CCACCATTCCCATTCTGTAA
CCCACGAAGAGACGTCGTTA -> CCACGAAGAGACGTCGTTAG
CCCAGAGCACAGGTATAGAG -> CCAGAGCACAGGTATAGAGC
CCCATTCTGTAATGCCCAAT -> CCATTCTGTAATGCCCAATT
CCCCACGAAGAGACGTCGTT -> CCCACGAAGAGACGTCGTTA
CCCCCTGGTGTCAGAAGGCA -> CCCCTGGTGTCAGAAGGCAG
CCCCTGGTGTCAGAAGGCAG -> CCCTGGTGTCAGAAGGCAGC
CCCGATCAGAATTCATGCCG -> CCGATCAGAATTCATGCCGG
CCCGCGTCGGTCGTCCCGGG -> CCGCGTCGGTCGTCCCGGGT
CCCGGAGCCCACCATTCCCA -> CCGGAGCCCACCATTCCCAT
CCCGGGTATGAGAATTTGCC -> CCGGGTATGAGAATTTGCCG
CCCGTGGACACGGTTTCACG -> CCGTGGACACGGTTTCACGT
CCCTAACTACTACCTGTGAC -> CCTAACTACTACCTGTGACA
CCCTAGAGGCGCACGGGCCC -> CCTAGAGGCGCACGGGCCCG
CCCTAGGTGAACATGACGCC -> CCTAGGTGAACATGACGCCG
CCCTGGCGCTCCGCGATAAC -> CCTGGCGCTCCGCGATAACT
CCCTGGTGTCAGAAGGCAGC -> CCTGGTGTCAGAAGGCAGCG
CCGAACCGGATTCGGGTTCT -> CGAACCGGATTCGGGTTCTA
CCGACATGCACTTTCTTACT -> CGACATGCACTTTCTTACTA
CCGACTACCGGCACTGTGAT -> CGACTACCGGCACTGTGATG
CCGACTCTCATGCGTGCGAT -> CGACTCTCATGCGTGCGATG
CCGACTTCCACTACTCCGTC -> CGACTTCCACTACTCCGTCT
CCGATCAGAATTCATGCCGG -> CGATCAGAATTCATGCCGGT
CCGCGATAACTATCCTCTAC -> CGCGATAACTATCCTCTACG
CCGCGCAAGAAGGTATTTTG -> CGCGCAAGAAGGTATTTTGG
CCGCGTCGGTCGTCCCGGGT -> CGCGTCGGTCGTCCCGGGTA
CCGGAGCCCACCATTCCCAT -> CGGAGCCCACCATTCCCATT
CCGGAGCTGTCTAGCGAGAG -> CGGAGCTGTCTAGCGAGAGC
CCGGATGGTCGTTCAGTGAT -> CGGATGGTCGTTCAGTGATA
CCGGATTCGGGTTCTAAGGT -> CGGATTCGGGTTCTAAGGTT
CCGGCACAAGTCACTCTATT -> CGGCACAAGTCACTCTATTT
CCGGCACTGTGATGTGCCCT -> CGGCACTGTGATGTGCCCTA
CCGGCCGACTCTCATGCGTG -> CGGCCGACTCTCATGCGTGC
CCGGCTGGTCCTGCATGAGT -> CGGCTGGTCCTGCATGAGTT
CCGGGCTGCATCCCGATCAG -> CGGGCTGCATCCCGATCAGA
CCGGGGCAGTCATACGGTAC -> CGGGGCAGTCATACGGTACA
CCGGGTATGAGAATTTGCCG -> CGGGTATGAGAATTTGCCGG
CCGGTAAACGTCAATAGTTT -> CGGTAAACGTCAATAGTTTC
CCGGTAAGCATTGCACGGTG -> CGGTAAGCATTGCACGGTGT
CCGTCTCCGGGGCAGTCATA -> CGTCTCCGGGGCAGTCATAC
CCGTGGACACGGTTTCACGT -> CGTGGACACGGTTTCACGTT
CCGTGTCGGGAGGGACCAGT -> CGTGTCGGGAGGGACCAGTG
CCTAACTACTACCTGTGACA -> CTAACTACTACCTGTGACAT
CCTACATAAACGTCCGGCCG -> CTACATAAACGTCCGGCCGA
CCTAGAGGCGCACGGGCCCG -> CTAGAGGCGCACGGGCCCGT
CCTAGGTGAACATGACGCCG -> CTAGGTGAACATGACGCCGC
CCTCCAAGCTTAGGGTCGCT -> CTCCAAGCTTAGGGTCGCTC
CCTCCGACATGCACTTTCTT -> CTCCGACATGCACTTTCTTA
CCTCGCCCGCGTCGGTCGTC -> CTCGCCCGCGTCGGTCGTCC
CCTCTACGTGGGGTGTCGGC -> CTCTACGTGGGGTGTCGGCC
CCTGCATGAGTTAGCTTTTA -> CTGCATGAGTTAGCTTTTAG
CCTGGCGCTCCGCGATAACT -> CTGGCGCTCCGCGATAACTA
CCTGGGGGCTCATACCGGTA -> CTGGGGGCTCATACCGGTAA
CCTGGTGTCAGAAGGCAGCG -> CTGGTGTCAGAAGGCAGCGT
CCTGTGACATACATCAGGCC -> CTGTGACATACATCAGGCCC
CCTGTTCGTTTTAACCATGT -> CTGTTCGTTTTAACCATGTC
CCTTCAAGGGCTCAAGACCC -> CTTCAAGGGCTCAAGACCCC
CGAACCGGATTCGGGTTCTA -> GAACCGGATTCGGGTTCTAA
CGAAGAGACGTCGTTAGCGC -> GAAGAGACGTCGTTAGCGCC
CGAATTTCTTCATTGAAACC -> GAATTTCTTCATTGAAACCG
CGACATGCACTTTCTTACTA -> GACATGCACTTTCTTACTAA
CGACCAGTATACGAGTGCCG -> GACCAGTATACGAGTGCCGA
CGACTACCGGCACTGTGATG -> GACTACCGGCACTGTGATGT
CGACTCTCATGCGTGCGATG -> GACTCTCATGCGTGCGATGC
CGACTTCCACTACTCCGTCT -> GACTTCCACTACTCCGTCTC
CGAGAGCCCTAGGTGAACAT -> GAGAGCCCTAGGTGAACATG
CGAGGATCCGGCACAAGTCA -> GAGGATCCGGCACAAGTCAC
CGAGTGCCGACTTCCACTAC -> GAGTGCCGACTTCCACTACT
CGATAACTATCCTCTACGTG -> GATAACTATCCTCTACGTGG
CGATCAGAATTCATGCCGGT -> GATCAGAATTCATGCCGGTA
CGATCTGGGGAGTCCCTAGA -> GATCTGGGGAGTCCCTAGAG
CGATGCGGGGATCTGGTGTC -> GATGCGGGGATCTGGTGTCA
CGATTAGACCTACATAAACG -> GATTAGACCTACATAAACGT
CGCAAGAAGGTATTTTGGTG -> GCAAGAAGGTATTTTGGTGG
CGCACGGGCCCGTGGACACG -> GCACGGGCCCGTGGACACGG
CGCCCGCGTCGGTCGTCCCG -> GCCCGCGTCGGTCGTCCCGG
CGCCGCGCAAGAAGGTATTT -> GCCGCGCAAGAAGGTATTTT
CGCCTCCAAGCTTAGGGTCG -> GCCTCCAAGCTTAGGGTCGC
CGCCTCCGACATGCACTTTC -> GCCTCCGACATGCACTTTCT
CGCGAATTTCTTCATTGAAA -> GCGAATTTCTTCATTGAAAC
CGCGATAACTATCCTCTACG -> GCGATAACTATCCTCTACGT
CGCGCAAGAAGGTATTTTGG -> GCGCAAGAAGGTATTTTGGT
CGCGCGAATTTCTTCATTGA -> GCGCGAATTTCTTCATTGAA
CGCGCTCGGGACCGTGTCGG -> GCGCTCGGGACCGTGTCGGG
CGCGTCGGTCGTCCCGGGTA -> GCGTCGGTCGTCCCGGGTAT
CGCTCCGCGATAACTATCCT -> GCTCCGCGATAACTATCCTC
CGCTCGGGACCGTGTCGGGA -> GCTCGGGACCGTGTCGGGAG
CGCTCGTCCTGGGGGCTCAT -> GCTCGTCCTGGGGGCTCATA
CGCTGTCGTGGCCGGAGCTG -> GCTGTCGTGGCCGGAGCTGT
CGGAGCCCACCATTCCCATT -> GGAGCCCACCATTCCCATTC
CGGAGCTGTCTAGCGAGAGC -> GGAGCTGTCTAGCGAGAGCC
CGGATGGTCGTTCAGTGATA -> GGATGGTCGTTCAGTGATAA
CGGATTCGGGTTCTAAGGTT -> GGATTCGGGTTCTAAGGTTC
CGGCACAAGTCACTCTATTT -> GGCACAAGTCACTCTATTTC
CGGCACTGTGATGTGCCCTA -> GGCACTGTGATGTGCCCTAA
CGGCCGAACCGGATTCGGGT -> GGCCGAACCGGATTCGGGTT
CGGCCGACTCTCATGCGTGC -> GGCCGACTCTCATGCGTGCG
CGGCGCCTCCAAGCTTAGGG -> GGCGCCTCCAAGCTTAGGGT
CGGCTGGTCCTGCATGAGTT -> GGCTGGTCCTGCATGAGTTA
CGGGACCGTGTCGGGAGGGA -> GGGACCGTGTCGGGAGGGAC
CGGGAGGGACCAGTGTAACC -> GGGAGGGACCAGTGTAACCG
CGGGCCCGTGGACACGGTTT -> GGGCCCGTGGACACGGTTTC
CGGGCTGCATCCCGATCAGA -> GGGCTGCATCCCGATCAGAA
CGGGGAAAGAGGCTGCTATC -> GGGGAAAGAGGCTGCTATCG
CGGGGATCTGGTGTCATGCA -> GGGGATCTGGTGTCATGCAG
CGGGGCAGTCATACGGTACA -> GGGGCAGTCATACGGTACAC
CGGGTATGAGAATTTGCCGG -> GGGTATGAGAATTTGCCGGG
CGGGTTCTAAGGTTCCTGTT -> GGGTTCTAAGGTTCCTGTTC
CGGTAAACGTCAATAGTTTC -> GGTAAACGTCAATAGTTTCG
CGGTAAGCATTGCACGGTGT -> GGTAAGCATTGCACGGTGTG
CGGTACACCCAGAGCACAGG -> GGTACACCCAGAGCACAGGT
CGGTCGTCCCGGGTATGAGA -> GGTCGTCCCGGGTATGAGAA
CGGTGTGTCTTACGTCGTTT -> GGTGTGTCTTACGTCGTTTA
CGGTTTCACGTTTTCTCAGG -> GGTTTCACGTTTTCTCAGGT
CGTAGCGGGGAAAGAGGCTG -> GTAGCGGGGAAAGAGGCTGC
CGTCAATAGTTTCGAGGATC -> GTCAATAGTTTCGAGGATCC
CGTCCCGGGTATGAGAATTT -> GTCCCGGGTATGAGAATTTG
CGTCCGGCCGACTCTCATGC -> GTCCGGCCGACTCTCATGCG
CGTCCTGGGGGCTCATACCG -> GTCCTGGGGGCTCATACCGG
CGTCGATCTGGGGAGTCCCT -> GTCGATCTGGGGAGTCCCTA
CGTCGGTCGTCCCGGGTATG -> GTCGGTCGTCCCGGGTATGA
CGTCGTTAGCGCCTCCGACA -> GTCGTTAGCGCCTCCGACAT
CGTCGTTTAAGTTTAGCTCC -> GTCGTTTAAGTTTAGCTCCG
CGTCTCCGGGGCAGTCATAC -> GTCTCCGGGGCAGTCATACG
CGTGATTCTACCCTGGCGCT -> GTGATTCTACCCTGGCGCTC
CGTGCGATGCGGGGATCTGG -> GTGCGATGCGGGGATCTGGT
CGTGGACACGGTTTCACGTT -> GTGGACACGGTTTCACGTTT
CGTGGCCGGAGCTGTCTAGC -> GTGGCCGGAGCTGTCTAGCG
CGTGGGGTGTCGGCCGAACC -> GTGGGGTGTCGGCCGAACCG
CGTGTCGGGAGGGACCAGTG -> GTGTCGGGAGGGACCAGTGT
CGTTAGCGCCTCCGACATGC -> GTTAGCGCCTCCGACATGCA
CGTTCAGTGATAACAGTGAA -> GTTCAGTGATAACAGTGAAT
CGTTTAAGTTTAGCTCCGAC -> GTTTAAGTTTAGCTCCGACT
CGTTTTAACCATGTCTACTA -> GTTTTAACCATGTCTACTAC
CGTTTTCTCAGGTTATTTGC -> GTTTTCTCAGGTTATTTGCC
CTAACTACTACCTGTGACAT -> TAACTACTACCTGTGACATA
CTAAGGTTCCTGTTCGTTTT -> TAAGGTTCCTGTTCGTTTTA
CTAAGTCACCGGATGGTCGT -> TAAGTCACCGGATGGTCGTT
CTACATAAACGTCCGGCCGA -> TACATAAACGTCCGGCCGAC
CTACCCTGGCGCTCCGCGAT -> TACCCTGGCGCTCCGCGATA
CTACCGGCACTGTGATGTGC -> TACCGGCACTGTGATGTGCC
CTACCTGTGACATACATCAG -> TACCTGTGACATACATCAGG
CTACGTGGGGTGTCGGCCGA -> TACGTGGGGTGTCGGCCGAA
CTACTACCTGTGACATACAT -> TACTACCTGTGACATACATC
CTACTACTTCCTTCAAGGGC -> TACTACTTCCTTCAAGGGCT
CTACTCCGTCTCCGGGGCAG -> TACTCCGTCTCCGGGGCAGT
CTACTTCCTTCAAGGGCTCA -> TACTTCCTTCAAGGGCTCAA
CTAGAGGCGCACGGGCCCGT -> TAGAGGCGCACGGGCCCGTG
CTAGCGAGAGCCCTAGGTGA -> TAGCGAGAGCCCTAGGTGAA
CTAGGTGAACATGACGCCGC -> TAGGTGAACATGACGCCGCG
CTATAGTAACCTCGCCCGCG -> TATAGTAACCTCGCCCGCGT
CTATCCTCTACGTGGGGTGT -> TATCCTCTACGTGGGGTGTC
CTATCGGCGCCTCCAAGCTT -> TATCGGCGCCTCCAAGCTTA
CTATCGTGATTCTACCCTGG -> TATCGTGATTCTACCCTGGC
CTATTTCATGTAACAAAAAA -> TATTTCATGTAACAAAAAAT
CTCAAGACCCCACGAAGAGA -> TCAAGACCCCACGAAGAGAC
CTCAGGTTATTTGCCCAAGG -> TCAGGTTATTTGCCCAAGGG
CTCATACCGGTAAACGTCAA -> TCATACCGGTAAACGTCAAT
CTCATGCGTGCGATGCGGGG -> TCATGCGTGCGATGCGGGGA
CTCCAAGCTTAGGGTCGCTC -> TCCAAGCTTAGGGTCGCTCG
CTCCGACATGCACTTTCTTA -> TCCGACATGCACTTTCTTAC
CTCCGACTACCGGCACTGTG -> TCCGACTACCGGCACTGTGA
CTCCGCGATAACTATCCTCT -> TCCGCGATAACTATCCTCTA
CTCCGGGGCAGTCATACGGT -> TCCGGGGCAGTCATACGGTA
CTCCGTCTCCGGGGCAGTCA -> TCCGTCTCCGGGGCAGTCAT
CTCGCCCGCGTCGGTCGTCC -> TCGCCCGCGTCGGTCGTCCC
CTCGGGACCGTGTCGGGAGG -> TCGGGACCGTGTCGGGAGGG
CTCGTCCTGGGGGCTCATAC -> TCGTCCTGGGGGCTCATACC
CTCTACGTGGGGTGTCGGCC -> TCTACGTGGGGTGTCGGCCG
CTCTATCGGCGCCTCCAAGC -> TCTATCGGCGCCTCCAAGCT
CTCTATTTCATGTAACAAAA -> TCTATTTCATGTAACAAAAA
CTCTCATGCGTGCGATGCGG -> TCTCATGCGTGCGATGCGGG
CTGCATCCCGATCAGAATTC -> TGCATCCCGATCAGAATTCA
CTGCATGAGTTAGCTTTTAG -> TGCATGAGTTAGCTTTTAGA
CTGCTATCGTGATTCTACCC -> TGCTATCGTGATTCTACCCT
CTGGCGCTCCGCGATAACTA -> TGGCGCTCCGCGATAACTAT
CTGGGGAGTCCCTAGAGGCG -> TGGGGAGTCCCTAGAGGCGC
CTGGGGGCTCATACCGGTAA -> TGGGGGCTCATACCGGTAAA
CTGGTCCTGCATGAGTTAGC -> TGGTCCTGCATGAGTTAGCT
CTGGTGTCAGAAGGCAGCGT -> TGGTGTCAGAAGGCAGCGTA
CTGGTGTCATGCAGTCATTA -> TGGTGTCATGCAGTCATTAA
CTGTAATGCCCAATTTACGC -> TGTAATGCCCAATTTACGCG
CTGTCGTGGCCGGAGCTGTC -> TGTCGTGGCCGGAGCTGTCT
CTGTCTAGCGAGAGCCCTAG -> TGTCTAGCGAGAGCCCTAGG
CTGTGACATACATCAGGCCC -> TGTGACATACATCAGGCCCC
CTGTGATGTGCCCTAACTAC -> TGTGATGTGCCCTAACTACT
CTGTTCGTTTTAACCATGTC -> TGTTCGTTTTAACCATGTCT
CTTACGTCGTTTAAGTTTAG -> TTACGTCGTTTAAGTTTAGC
CTTACTAAGTCACCGGATGG -> TTACTAAGTCACCGGATGGT
CTTAGGGTCGCTCGTCCTGG -> TTAGGGTCGCTCGTCCTGGG
CTTCAAGGGCTCAAGACCCC -> TTCAAGGGCTCAAGACCCCA
CTTCCACTACTCCGTCTCCG -> TTCCACTACTCCGTCTCCGG
CTTCCTTCAAGGGCTCAAGA -> TTCCTTCAAGGGCTCAAGAC
CTTTCTTACTAAGTCACCGG -> TTTCTTACTAAGTCACCGGA
CTTTTAGATCTCTATCGGCG -> TTTTAGATCTCTATCGGCGC
GAAAGAGGCTGCTATCGTGA -> AAAGAGGCTGCTATCGTGAT
GAACATGACGCCGCGCAAGA -> AACATGACGCCGCGCAAGAA
GAACCGGATTCGGGTTCTAA -> AACCGGATTCGGGTTCTAAG
GAAGAGACGTCGTTAGCGCC -> AAGAGACGTCGTTAGCGCCT
GAAGGCAGCGTAGCGGGGAA -> AAGGCAGCGTAGCGGGGAAA
GAAGGTATTTTGGTGGCATC -> AAGGTATTTTGGTGGCATCT
GAATCCCGGAGCCCACCATT -> AATCCCGGAGCCCACCATTC
GAATTCATGCCGGTAAGCAT -> AATTCATGCCGGTAAGCATT
GAATTTCTTCATTGAAACCG -> AATTTCTTCATTGAAACCGC
GAATTTGCCGGGCTGCATCC -> AATTTGCCGGGCTGCATCCC
GACACGGTTTCACGTTTTCT -> ACACGGTTTCACGTTTTCTC
GACATACATCAGGCCCCCTG -> ACATACATCAGGCCCCCTGG
GACATGCACTTTCTTACTAA -> ACATGCACTTTCTTACTAAG
GACCAGTATACGAGTGCCGA -> ACCAGTATACGAGTGCCGAC
GACCAGTGTAACCGGCTGGT -> ACCAGTGTAACCGGCTGGTC
GACCCCACGAAGAGACGTCG -> ACCCCACGAAGAGACGTCGT
GACCGTGTCGGGAGGGACCA -> ACCGTGTCGGGAGGGACCAG
GACCTACATAAACGTCCGGC -> ACCTACATAAACGTCCGGCC
GACGCCGCGCAAGAAGGTAT -> ACGCCGCGCAAGAAGGTATT
GACGTCGTTAGCGCCTCCGA -> ACGTCGTTAGCGCCTCCGAC
GACTACCGGCACTGTGATGT -> ACTACCGGCACTGTGATGTG
GACTCTCATGCGTGCGATGC -> ACTCTCATGCGTGCGATGCG
GACTTCCACTACTCCGTCTC -> ACTTCCACTACTCCGTCTCC
GAGAATTTGCCGGGCTGCAT -> AGAATTTGCCGGGCTGCATC
GAGACGTCGTTAGCGCCTCC -> AGACGTCGTTAGCGCCTCCG
GAGAGCCCTAGGTGAACATG -> AGAGCCCTAGGTGAACATGA
GAGCACAGGTATAGAGCATA -> AGCACAGGTATAGAGCATAG
GAGCATAGGTACGTCGATCT -> AGCATAGGTACGTCGATCTG
GAGCCCACCATTCCCATTCT -> AGCCCACCATTCCCATTCTG
GAGCCCTAGGTGAACATGAC -> AGCCCTAGGTGAACATGACG
GAGCTGTCTAGCGAGAGCCC -> AGCTGTCTAGCGAGAGCCCT
GAGGATCCGGCACAAGTCAC -> AGGATCCGGCACAAGTCACT
GAGGCGCACGGGCCCGTGGA -> AGGCGCACGGGCCCGTGGAC
GAGGCTGCTATCGTGATTCT -> AGGCTGCTATCGTGATTCTA
GAGGGACCAGTGTAACCGGC -> AGGGACCAGTGTAACCGGCT
GAGTCCCTAGAGGCGCACGG -> AGTCCCTAGAGGCGCACGGG
GAGTGCCGACTTCCACTACT -> AGTGCCGACTTCCACTACTC
GAGTTAGCTTTTAGATCTCT -> AGTTAGCTTTTAGATCTCTA
GATAACAGTGAATCCCGGAG -> ATAACAGTGAATCCCGGAGC
GATAACTATCCTCTACGTGG -> ATAACTATCCTCTACGTGGG
GATCAGAATTCATGCCGGTA -> ATCAGAATTCATGCCGGTAA
GATCCGGCACAAGTCACTCT -> ATCCGGCACAAGTCACTCTA
GATCTCTATCGGCGCCTCCA -> ATCTCTATCGGCGCCTCCAA
GATCTGGGGAGTCCCTAGAG -> ATCTGGGGAGTCCCTAGAGG
GATCTGGTGTCATGCAGTCA -> ATCTGGTGTCATGCAGTCAT
GATGCGGGGATCTGGTGTCA -> ATGCGGGGATCTGGTGTCAT
GATGGTCGTTCAGTGATAAC -> ATGGTCGTTCAGTGATAACA
GATGTGCCCTAACTACTACC -> ATGTGCCCTAACTACTACCT
GATTAGACCTACATAAACGT -> ATTAGACCTACATAAACGTC
GATTCGGGTTCTAAGGTTCC -> ATTCGGGTTCTAAGGTTCCT
GATTCTACCCTGGCGCTCCG -> ATTCTACCCTGGCGCTCCGC
GCAAGAAGGTATTTTGGTGG -> CAAGAAGGTATTTTGGTGGC
GCACAAGTCACTCTATTTCA -> CACAAGTCACTCTATTTCAT
GCACAGGTATAGAGCATAGG -> CACAGGTATAGAGCATAGGT
GCACGGGCCCGTGGACACGG -> CACGGGCCCGTGGACACGGT
GCACGGTGTGTCTTACGTCG -> CACGGTGTGTCTTACGTCGT
GCACTGTGATGTGCCCTAAC -> CACTGTGATGTGCCCTAACT
GCACTTTCTTACTAAGTCAC -> CACTTTCTTACTAAGTCACC
GCAGCGTAGCGGGGAAAGAG -> CAGCGTAGCGGGGAAAGAGG
GCAGTCATACGGTACACCCA -> CAGTCATACGGTACACCCAG
GCAGTCATTAATCGCTGTCG -> CAGTCATTAATCGCTGTCGT
GCATAGGTACGTCGATCTGG -> CATAGGTACGTCGATCTGGG
GCATCCCGATCAGAATTCAT -> CATCCCGATCAGAATTCATG
GCATCTATAGTAACCTCGCC -> CATCTATAGTAACCTCGCCC
GCATGAGTTAGCTTTTAGAT -> CATGAGTTAGCTTTTAGATC
GCATTGCACGGTGTGTCTTA -> CATTGCACGGTGTGTCTTAC
GCCCAAGGGCGCGCGAATTT -> CCCAAGGGCGCGCGAATTTC
GCCCAATTTACGCGCTCGGG -> CCCAATTTACGCGCTCGGGA
GCCCACCATTCCCATTCTGT -> CCCACCATTCCCATTCTGTA
GCCCCCTGGTGTCAGAAGGC -> CCCCCTGGTGTCAGAAGGCA
GCCCGCGTCGGTCGTCCCGG -> CCCGCGTCGGTCGTCCCGGG
GCCCGTGGACACGGTTTCAC -> CCCGTGGACACGGTTTCACG
GCCCTAACTACTACCTGTGA -> CCCTAACTACTACCTGTGAC
GCCCTAGGTGAACATGACGC -> CCCTAGGTGAACATGACGCC
GCCGAACCGGATTCGGGTTC -> CCGAACCGGATTCGGGTTCT
GCCGACTCTCATGCGTGCGA -> CCGACTCTCATGCGTGCGAT
GCCGACTTCCACTACTCCGT -> CCGACTTCCACTACTCCGTC
GCCGCGCAAGAAGGTATTTT -> CCGCGCAAGAAGGTATTTTG
GCCGGAGCTGTCTAGCGAGA -> CCGGAGCTGTCTAGCGAGAG
GCCGGGCTGCATCCCGATCA -> CCGGGCTGCATCCCGATCAG
GCCGGTAAGCATTGCACGGT -> CCGGTAAGCATTGCACGGTG
GCCTCCAAGCTTAGGGTCGC -> CCTCCAAGCTTAGGGTCGCT
GCCTCCGACATGCACTTTCT -> CCTCCGACATGCACTTTCTT
GCGAATTTCTTCATTGAAAC -> CGAATTTCTTCATTGAAACC
GCGACCAGTATACGAGTGCC -> CGACCAGTATACGAGTGCCG
GCGAGAGCCCTAGGTGAACA -> CGAGAGCCCTAGGTGAACAT
GCGATAACTATCCTCTACGT -> CGATAACTATCCTCTACGTG
GCGATGCGGGGATCTGGTGT -> CGATGCGGGGATCTGGTGTC
GCGCAAGAAGGTATTTTGGT -> CGCAAGAAGGTATTTTGGTG
GCGCACGGGCCCGTGGACAC -> CGCACGGGCCCGTGGACACG
GCGCCTCCAAGCTTAGGGTC -> CGCCTCCAAGCTTAGGGTCG
GCGCCTCCGACATGCACTTT -> CGCCTCCGACATGCACTTTC
GCGCGAATTTCTTCATTGAA -> CGCGAATTTCTTCATTGAAA
GCGCGCGAATTTCTTCATTG -> CGCGCGAATTTCTTCATTGA
GCGCTCCGCGATAACTATCC -> CGCTCCGCGATAACTATCCT
GCGCTCGGGACCGTGTCGGG -> CGCTCGGGACCGTGTCGGGA
GCGGGGAAAGAGGCTGCTAT -> CGGGGAAAGAGGCTGCTATC
GCGGGGATCTGGTGTCATGC -> CGGGGATCTGGTGTCATGCA
GCGTAGCGGGGAAAGAGGCT -> CGTAGCGGGGAAAGAGGCTG
GCGTCGGTCGTCCCGGGTAT -> CGTCGGTCGTCCCGGGTATG
GCGTGCGATGCGGGGATCTG -> CGTGCGATGCGGGGATCTGG
GCTATCGTGATTCTACCCTG -> CTATCGTGATTCTACCCTGG
GCTCAAGACCCCACGAAGAG -> CTCAAGACCCCACGAAGAGA
GCTCATACCGGTAAACGTCA -> CTCATACCGGTAAACGTCAA
GCTCCGACTACCGGCACTGT -> CTCCGACTACCGGCACTGTG
GCTCCGCGATAACTATCCTC -> CTCCGCGATAACTATCCTCT
GCTCGGGACCGTGTCGGGAG -> CTCGGGACCGTGTCGGGAGG
GCTCGTCCTGGGGGCTCATA -> CTCGTCCTGGGGGCTCATAC
GCTGCATCCCGATCAGAATT -> CTGCATCCCGATCAGAATTC
GCTGCTATCGTGATTCTACC -> CTGCTATCGTGATTCTACCC
GCTGGTCCTGCATGAGTTAG -> CTGGTCCTGCATGAGTTAGC
GCTGTCGTGGCCGGAGCTGT -> CTGTCGTGGCCGGAGCTGTC
GCTGTCTAGCGAGAGCCCTA -> CTGTCTAGCGAGAGCCCTAG
GCTTAGGGTCGCTCGTCCTG -> CTTAGGGTCGCTCGTCCTGG
GCTTTTAGATCTCTATCGGC -> CTTTTAGATCTCTATCGGCG
GGAAAGAGGCTGCTATCGTG -> GAAAGAGGCTGCTATCGTGA
GGACACGGTTTCACGTTTTC -> GACACGGTTTCACGTTTTCT
GGACCAGTGTAACCGGCTGG -> GACCAGTGTAACCGGCTGGT
GGACCGTGTCGGGAGGGACC -> GACCGTGTCGGGAGGGACCA
GGAGCCCACCATTCCCATTC -> GAGCCCACCATTCCCATTCT
GGAGCTGTCTAGCGAGAGCC -> GAGCTGTCTAGCGAGAGCCC
GGAGGGACCAGTGTAACCGG -> GAGGGACCAGTGTAACCGGC
GGAGTCCCTAGAGGCGCACG -> GAGTCCCTAGAGGCGCACGG
GGATCCGGCACAAGTCACTC -> GATCCGGCACAAGTCACTCT
GGATCTGGTGTCATGCAGTC -> GATCTGGTGTCATGCAGTCA
GGATGGTCGTTCAGTGATAA -> GATGGTCGTTCAGTGATAAC
GGATTCGGGTTCTAAGGTTC -> GATTCGGGTTCTAAGGTTCC
GGCACAAGTCACTCTATTTC -> GCACAAGTCACTCTATTTCA
GGCACTGTGATGTGCCCTAA -> GCACTGTGATGTGCCCTAAC
GGCAGCGTAGCGGGGAAAGA -> GCAGCGTAGCGGGGAAAGAG
GGCAGTCATACGGTACACCC -> GCAGTCATACGGTACACCCA
GGCATCTATAGTAACCTCGC -> GCATCTATAGTAACCTCGCC
GGCCCCCTGGTGTCAGAAGG -> GCCCCCTGGTGTCAGAAGGC
GGCCCGTGGACACGGTTTCA -> GCCCGTGGACACGGTTTCAC
GGCCGAACCGGATTCGGGTT -> GCCGAACCGGATTCGGGTTC
GGCCGACTCTCATGCGTGCG -> GCCGACTCTCATGCGTGCGA
GGCCGGAGCTGTCTAGCGAG -> GCCGGAGCTGTCTAGCGAGA
GGCGCACGGGCCCGTGGACA -> GCGCACGGGCCCGTGGACAC
GGCGCCTCCAAGCTTAGGGT -> GCGCCTCCAAGCTTAGGGTC
GGCGCGCGAATTTCTTCATT -> GCGCGCGAATTTCTTCATTG
GGCGCTCCGCGATAACTATC -> GCGCTCCGCGATAACTATCC
GGCTCAAGACCCCACGAAGA -> GCTCAAGACCCCACGAAGAG
GGCTCATACCGGTAAACGTC -> GCTCATACCGGTAAACGTCA
GGCTGCATCCCGATCAGAAT -> GCTGCATCCCGATCAGAATT
GGCTGCTATCGTGATTCTAC -> GCTGCTATCGTGATTCTACC
GGCTGGTCCTGCATGAGTTA -> GCTGGTCCTGCATGAGTTAG
GGGAAAGAGGCTGCTATCGT -> GGAAAGAGGCTGCTATCGTG
GGGACCAGTGTAACCGGCTG -> GGACCAGTGTAACCGGCTGG
GGGACCGTGTCGGGAGGGAC -> GGACCGTGTCGGGAGGGACC
GGGAGGGACCAGTGTAACCG -> GGAGGGACCAGTGTAACCGG
GGGAGTCCCTAGAGGCGCAC -> GGAGTCCCTAGAGGCGCACG
GGGATCTGGTGTCATGCAGT -> GGATCTGGTGTCATGCAGTC
GGGCAGTCATACGGTACACC -> GGCAGTCATACGGTACACCC
GGGCCCGTGGACACGGTTTC -> GGCCCGTGGACACGGTTTCA
GGGCGCGCGAATTTCTTCAT -> GGCGCGCGAATTTCTTCATT
GGGCTCAAGACCCCACGAAG -> GGCTCAAGACCCCACGAAGA
GGGCTCATACCGGTAAACGT -> GGCTCATACCGGTAAACGTC
GGGCTGCATCCCGATCAGAA -> GGCTGCATCCCGATCAGAAT
GGGGAAAGAGGCTGCTATCG -> GGGAAAGAGGCTGCTATCGT
GGGGAGTCCCTAGAGGCGCA -> GGGAGTCCCTAGAGGCGCAC
GGGGATCTGGTGTCATGCAG -> GGGATCTGGTGTCATGCAGT
GGGGCAGTCATACGGTACAC -> GGGCAGTCATACGGTACACC
GGGGCTCATACCGGTAAACG -> GGGCTCATACCGGTAAACGT
GGGGGCTCATACCGGTAAAC -> GGGGCTCATACCGGTAAACG
GGGGTGTCGGCCGAACCGGA -> GGGTGTCGGCCGAACCGGAT
GGGTATGAGAATTTGCCGGG -> GGTATGAGAATTTGCCGGGC
GGGTCGCTCGTCCTGGGGGC -> GGTCGCTCGTCCTGGGGGCT
GGGTGTCGGCCGAACCGGAT -> GGTGTCGGCCGAACCGGATT
GGGTTCTAAGGTTCCTGTTC -> GGTTCTAAGGTTCCTGTTCG
GGTAAACGTCAATAGTTTCG -> GTAAACGTCAATAGTTTCGA
GGTAAGCATTGCACGGTGTG -> GTAAGCATTGCACGGTGTGT
GGTACACCCAGAGCACAGGT -> GTACACCCAGAGCACAGGTA
GGTACGTCGATCTGGGGAGT -> GTACGTCGATCTGGGGAGTC
GGTATAGAGCATAGGTACGT -> GTATAGAGCATAGGTACGTC
GGTATGAGAATTTGCCGGGC -> GTATGAGAATTTGCCGGGCT
GGTATTTTGGTGGCATCTAT -> GTATTTTGGTGGCATCTATA
GGTCCTGCATGAGTTAGCTT -> GTCCTGCATGAGTTAGCTTT
GGTCGCTCGTCCTGGGGGCT -> GTCGCTCGTCCTGGGGGCTC
GGTCGTCCCGGGTATGAGAA -> GTCGTCCCGGGTATGAGAAT
GGTCGTTCAGTGATAACAGT -> GTCGTTCAGTGATAACAGTG
GGTGAACATGACGCCGCGCA -> GTGAACATGACGCCGCGCAA
GGTGGCATCTATAGTAACCT -> GTGGCATCTATAGTAACCTC
GGTGTCAGAAGGCAGCGTAG -> GTGTCAGAAGGCAGCGTAGC
GGTGTCATGCAGTCATTAAT -> GTGTCATGCAGTCATTAATC
GGTGTCGGCCGAACCGGATT -> GTGTCGGCCGAACCGGATTC
GGTGTGTCTTACGTCGTTTA -> GTGTGTCTTACGTCGTTTAA
GGTTATTTGCCCAAGGGCGC -> GTTATTTGCCCAAGGGCGCG
GGTTCCTGTTCGTTTTAACC -> GTTCCTGTTCGTTTTAACCA
GGTTCTAAGGTTCCTGTTCG -> GTTCTAAGGTTCCTGTTCGT
GGTTTCACGTTTTCTCAGGT -> GTTTCACGTTTTCTCAGGTT
GTAAACGTCAATAGTTTCGA -> TAAACGTCAATAGTTTCGAG
GTAACAAAAAATTGTGTACA -> TAACAAAAAATTGTGTACAT
GTAACCGGCTGGTCCTGCAT -> TAACCGGCTGGTCCTGCATG
GTAACCTCGCCCGCGTCGGT -> TAACCTCGCCCGCGTCGGTC
GTAAGCATTGCACGGTGTGT -> TAAGCATTGCACGGTGTGTC
GTAATGCCCAATTTACGCGC -> TAATGCCCAATTTACGCGCT
GTACACCCAGAGCACAGGTA -> TACACCCAGAGCACAGGTAT
GTACATGTTGCGACCAGTAT -> TACATGTTGCGACCAGTATA
GTACGTCGATCTGGGGAGTC -> TACGTCGATCTGGGGAGTCC
GTAGCGGGGAAAGAGGCTGC -> TAGCGGGGAAAGAGGCTGCT
GTATACGAGTGCCGACTTCC -> TATACGAGTGCCGACTTCCA
GTATAGAGCATAGGTACGTC -> TATAGAGCATAGGTACGTCG
GTATGAGAATTTGCCGGGCT -> TATGAGAATTTGCCGGGCTG
GTATTTTGGTGGCATCTATA -> TATTTTGGTGGCATCTATAG
GTCAATAGTTTCGAGGATCC -> TCAATAGTTTCGAGGATCCG
GTCACCGGATGGTCGTTCAG -> TCACCGGATGGTCGTTCAGT
GTCACTCTATTTCATGTAAC -> TCACTCTATTTCATGTAACA
GTCAGAAGGCAGCGTAGCGG -> TCAGAAGGCAGCGTAGCGGG
GTCATACGGTACACCCAGAG -> TCATACGGTACACCCAGAGC
GTCATGCAGTCATTAATCGC -> TCATGCAGTCATTAATCGCT
GTCATTAATCGCTGTCGTGG -> TCATTAATCGCTGTCGTGGC
GTCCCGGGTATGAGAATTTG -> TCCCGGGTATGAGAATTTGC
GTCCCTAGAGGCGCACGGGC -> TCCCTAGAGGCGCACGGGCC
GTCCGGCCGACTCTCATGCG -> TCCGGCCGACTCTCATGCGT
GTCCTGCATGAGTTAGCTTT -> TCCTGCATGAGTTAGCTTTT
GTCCTGGGGGCTCATACCGG -> TCCTGGGGGCTCATACCGGT
GTCGATCTGGGGAGTCCCTA -> TCGATCTGGGGAGTCCCTAG
GTCGCTCGTCCTGGGGGCTC -> TCGCTCGTCCTGGGGGCTCA
GTCGGCCGAACCGGATTCGG -> TCGGCCGAACCGGATTCGGG
GTCGGGAGGGACCAGTGTAA -> TCGGGAGGGACCAGTGTAAC
GTCGGTCGTCCCGGGTATGA -> TCGGTCGTCCCGGGTATGAG
GTCGTCCCGGGTATGAGAAT -> TCGTCCCGGGTATGAGAATT
GTCGTGGCCGGAGCTGTCTA -> TCGTGGCCGGAGCTGTCTAG
GTCGTTAGCGCCTCCGACAT -> TCGTTAGCGCCTCCGACATG
GTCGTTCAGTGATAACAGTG -> TCGTTCAGTGATAACAGTGA
GTCGTTTAAGTTTAGCTCCG -> TCGTTTAAGTTTAGCTCCGA
GTCTACTACTTCCTTCAAGG -> TCTACTACTTCCTTCAAGGG
GTCTAGCGAGAGCCCTAGGT -> TCTAGCGAGAGCCCTAGGTG
GTCTCCGGGGCAGTCATACG -> TCTCCGGGGCAGTCATACGG
GTCTTACGTCGTTTAAGTTT -> TCTTACGTCGTTTAAGTTTA
GTGAACATGACGCCGCGCAA -> TGAACATGACGCCGCGCAAG
GTGAATCCCGGAGCCCACCA -> TGAATCCCGGAGCCCACCAT
GTGACATACATCAGGCCCCC -> TGACATACATCAGGCCCCCT
GTGATAACAGTGAATCCCGG -> TGATAACAGTGAATCCCGGA
GTGATGTGCCCTAACTACTA -> TGATGTGCCCTAACTACTAC
GTGATTCTACCCTGGCGCTC -> TGATTCTACCCTGGCGCTCC
GTGCCCTAACTACTACCTGT -> TGCCCTAACTACTACCTGTG
GTGCCGACTTCCACTACTCC -> TGCCGACTTCCACTACTCCG
GTGCGATGCGGGGATCTGGT -> TGCGATGCGGGGATCTGGTG
GTGGACACGGTTTCACGTTT -> TGGACACGGTTTCACGTTTT
GTGGCATCTATAGTAACCTC -> TGGCATCTATAGTAACCTCG
GTGGCCGGAGCTGTCTAGCG -> TGGCCGGAGCTGTCTAGCGA
GTGGGGTGTCGGCCGAACCG -> TGGGGTGTCGGCCGAACCGG
GTGTAACCGGCTGGTCCTGC -> TGTAACCGGCTGGTCCTGCA
GTGTACATGTTGCGACCAGT -> TGTACATGTTGCGACCAGTA
GTGTCAGAAGGCAGCGTAGC -> TGTCAGAAGGCAGCGTAGCG
GTGTCATGCAGTCATTAATC -> TGTCATGCAGTCATTAATCG
GTGTCGGCCGAACCGGATTC -> TGTCGGCCGAACCGGATTCG
GTGTCGGGAGGGACCAGTGT -> TGTCGGGAGGGACCAGTGTA
GTGTCTTACGTCGTTTAAGT -> TGTCTTACGTCGTTTAAGTT
GTGTGTCTTACGTCGTTTAA -> TGTGTCTTACGTCGTTTAAG
GTTAGCGCCTCCGACATGCA -> TTAGCGCCTCCGACATGCAC
GTTAGCTTTTAGATCTCTAT -> TTAGCTTTTAGATCTCTATC
GTTATTTGCCCAAGGGCGCG -> TTATTTGCCCAAGGGCGCGC
GTTCAGTGATAACAGTGAAT -> TTCAGTGATAACAGTGAATC
GTTCCTGTTCGTTTTAACCA -> TTCCTGTTCGTTTTAACCAT
GTTCGTTTTAACCATGTCTA -> TTCGTTTTAACCATGTCTAC
GTTCTAAGGTTCCTGTTCGT -> TTCTAAGGTTCCTGTTCGTT
GTTGCGACCAGTATACGAGT -> TTGCGACCAGTATACGAGTG
GTTTAAGTTTAGCTCCGACT -> TTTAAGTTTAGCTCCGACTA
GTTTAGCTCCGACTACCGGC -> TTTAGCTCCGACTACCGGCA
GTTTCACGTTTTCTCAGGTT -> TTTCACGTTTTCTCAGGTTA
GTTTCGAGGATCCGGCACAA -> TTTCGAGGATCCGGCACAAG
GTTTTAACCATGTCTACTAC -> TTTTAACCATGTCTACTACT
GTTTTCTCAGGTTATTTGCC -> TTTTCTCAGGTTATTTGCCC
TAAACGTCAATAGTTTCGAG -> AAACGTCAATAGTTTCGAGG
TAAACGTCCGGCCGACTCTC -> AAACGTCCGGCCGACTCTCA
TAACAAAAAATTGTGTACAT -> AACAAAAAATTGTGTACATG
TAACAGTGAATCCCGGAGCC -> AACAGTGAATCCCGGAGCCC
TAACCATGTCTACTACTTCC -> AACCATGTCTACTACTTCCT
TAACCGGCTGGTCCTGCATG -> AACCGGCTGGTCCTGCATGA
TAACCTCGCCCGCGTCGGTC -> AACCTCGCCCGCGTCGGTCG
TAACTACTACCTGTGACATA -> AACTACTACCTGTGACATAC
TAACTATCCTCTACGTGGGG -> AACTATCCTCTACGTGGGGT
TAAGCATTGCACGGTGTGTC -> AAGCATTGCACGGTGTGTCT
TAAGGTTCCTGTTCGTTTTA -> AAGGTTCCTGTTCGTTTTAA
TAAGTCACCGGATGGTCGTT -> AAGTCACCGGATGGTCGTTC
TAAGTTTAGCTCCGACTACC -> AAGTTTAGCTCCGACTACCG
TAATCGCTGTCGTGGCCGGA -> AATCGCTGTCGTGGCCGGAG
TAATGCCCAATTTACGCGCT -> AATGCCCAATTTACGCGCTC
TACACCCAGAGCACAGGTAT -> ACACCCAGAGCACAGGTATA
TACATAAACGTCCGGCCGAC -> ACATAAACGTCCGGCCGACT
TACATCAGGCCCCCTGGTGT -> ACATCAGGCCCCCTGGTGTC
TACATGTTGCGACCAGTATA -> ACATGTTGCGACCAGTATAC
TACCCTGGCGCTCCGCGATA -> ACCCTGGCGCTCCGCGATAA
TACCGGCACTGTGATGTGCC -> ACCGGCACTGTGATGTGCCC
TACCGGTAAACGTCAATAGT -> ACCGGTAAACGTCAATAGTT
TACCTGTGACATACATCAGG -> ACCTGTGACATACATCAGGC
TACGAGTGCCGACTTCCACT -> ACGAGTGCCGACTTCCACTA
TACGCGCTCGGGACCGTGTC -> ACGCGCTCGGGACCGTGTCG
TACGGTACACCCAGAGCACA -> ACGGTACACCCAGAGCACAG
TACGTCGATCTGGGGAGTCC -> ACGTCGATCTGGGGAGTCCC
TACGTCGTTTAAGTTTAGCT -> ACGTCGTTTAAGTTTAGCTC
TACGTGGGGTGTCGGCCGAA -> ACGTGGGGTGTCGGCCGAAC
TACTAAGTCACCGGATGGTC -> ACTAAGTCACCGGATGGTCG
TACTACCTGTGACATACATC -> ACTACCTGTGACATACATCA
TACTACTTCCTTCAAGGGCT -> ACTACTTCCTTCAAGGGCTC
TACTCCGTCTCCGGGGCAGT -> ACTCCGTCTCCGGGGCAGTC
TACTTCCTTCAAGGGCTCAA -> ACTTCCTTCAAGGGCTCAAG
TAGACCTACATAAACGTCCG -> AGACCTACATAAACGTCCGG
TAGAGCATAGGTACGTCGAT -> AGAGCATAGGTACGTCGATC
TAGAGGCGCACGGGCCCGTG -> AGAGGCGCACGGGCCCGTGG
TAGATCTCTATCGGCGCCTC -> AGATCTCTATCGGCGCCTCC
TAGCGAGAGCCCTAGGTGAA -> AGCGAGAGCCCTAGGTGAAC
TAGCGCCTCCGACATGCACT -> AGCGCCTCCGACATGCACTT
TAGCGGGGAAAGAGGCTGCT -> AGCGGGGAAAGAGGCTGCTA
TAGCTCCGACTACCGGCACT -> AGCTCCGACTACCGGCACTG
TAGCTTTTAGATCTCTATCG -> AGCTTTTAGATCTCTATCGG
TAGGGTCGCTCGTCCTGGGG -> AGGGTCGCTCGTCCTGGGGG
TAGGTACGTCGATCTGGGGA -> AGGTACGTCGATCTGGGGAG
TAGGTGAACATGACGCCGCG -> AGGTGAACATGACGCCGCGC
TAGTAACCTCGCCCGCGTCG -> AGTAACCTCGCCCGCGTCGG
TAGTTTCGAGGATCCGGCAC -> AGTTTCGAGGATCCGGCACA
TATACGAGTGCCGACTTCCA -> ATACGAGTGCCGACTTCCAC
TATAGAGCATAGGTACGTCG -> ATAGAGCATAGGTACGTCGA
TATAGTAACCTCGCCCGCGT -> ATAGTAACCTCGCCCGCGTC
TATCCTCTACGTGGGGTGTC -> ATCCTCTACGTGGGGTGTCG
TATCGGCGCCTCCAAGCTTA -> ATCGGCGCCTCCAAGCTTAG
TATCGTGATTCTACCCTGGC -> ATCGTGATTCTACCCTGGCG
TATGAGAATTTGCCGGGCTG -> ATGAGAATTTGCCGGGCTGC
TATTTCATGTAACAAAAAAT -> ATTTCATGTAACAAAAAATT
TATTTGCCCAAGGGCGCGCG -> ATTTGCCCAAGGGCGCGCGA
TATTTTGGTGGCATCTATAG -> ATTTTGGTGGCATCTATAGT
TCAAGACCCCACGAAGAGAC -> CAAGACCCCACGAAGAGACG
TCAAGGGCTCAAGACCCCAC -> CAAGGGCTCAAGACCCCACG
TCAATAGTTTCGAGGATCCG -> CAATAGTTTCGAGGATCCGG
TCACCGGATGGTCGTTCAGT -> CACCGGATGGTCGTTCAGTG
TCACGTTTTCTCAGGTTATT -> CACGTTTTCTCAGGTTATTT
TCACTCTATTTCATGTAACA -> CACTCTATTTCATGTAACAA
TCAGAAGGCAGCGTAGCGGG -> CAGAAGGCAGCGTAGCGGGG
TCAGAATTCATGCCGGTAAG -> CAGAATTCATGCCGGTAAGC
TCAGGCCCCCTGGTGTCAGA -> CAGGCCCCCTGGTGTCAGAA
TCAGGTTATTTGCCCAAGGG -> CAGGTTATTTGCCCAAGGGC
TCAGTGATAACAGTGAATCC -> CAGTGATAACAGTGAATCCC
TCATACCGGTAAACGTCAAT -> CATACCGGTAAACGTCAATA
TCATACGGTACACCCAGAGC -> CATACGGTACACCCAGAGCA
TCATGCAGTCATTAATCGCT -> CATGCAGTCATTAATCGCTG
TCATGCCGGTAAGCATTGCA -> CATGCCGGTAAGCATTGCAC
TCATGCGTGCGATGCGGGGA -> CATGCGTGCGATGCGGGGAT
TCATGTAACAAAAAATTGTG -> CATGTAACAAAAAATTGTGT
TCATTAATCGCTGTCGTGGC -> CATTAATCGCTGTCGTGGCC
TCCAAGCTTAGGGTCGCTCG -> CCAAGCTTAGGGTCGCTCGT
TCCACTACTCCGTCTCCGGG -> CCACTACTCCGTCTCCGGGG
TCCCATTCTGTAATGCCCAA -> CCCATTCTGTAATGCCCAAT
TCCCGATCAGAATTCATGCC -> CCCGATCAGAATTCATGCCG
TCCCGGAGCCCACCATTCCC -> CCCGGAGCCCACCATTCCCA
TCCCGGGTATGAGAATTTGC -> CCCGGGTATGAGAATTTGCC
TCCCTAGAGGCGCACGGGCC -> CCCTAGAGGCGCACGGGCCC
TCCGACATGCACTTTCTTAC -> CCGACATGCACTTTCTTACT
TCCGACTACCGGCACTGTGA -> CCGACTACCGGCACTGTGAT
TCCGCGATAACTATCCTCTA -> CCGCGATAACTATCCTCTAC
TCCGGCACAAGTCACTCTAT -> CCGGCACAAGTCACTCTATT
TCCGGCCGACTCTCATGCGT -> CCGGCCGACTCTCATGCGTG
TCCGGGGCAGTCATACGGTA -> CCGGGGCAGTCATACGGTAC
TCCGTCTCCGGGGCAGTCAT -> CCGTCTCCGGGGCAGTCATA
TCCTCTACGTGGGGTGTCGG -> CCTCTACGTGGGGTGTCGGC
TCCTGCATGAGTTAGCTTTT -> CCTGCATGAGTTAGCTTTTA
TCCTGGGGGCTCATACCGGT -> CCTGGGGGCTCATACCGGTA
TCCTGTTCGTTTTAACCATG -> CCTGTTCGTTTTAACCATGT
TCCTTCAAGGGCTCAAGACC -> CCTTCAAGGGCTCAAGACCC
TCGAGGATCCGGCACAAGTC -> CGAGGATCCGGCACAAGTCA
TCGATCTGGGGAGTCCCTAG -> CGATCTGGGGAGTCCCTAGA
TCGCCCGCGTCGGTCGTCCC -> CGCCCGCGTCGGTCGTCCCG
TCGCTCGTCCTGGGGGCTCA -> CGCTCGTCCTGGGGGCTCAT
TCGCTGTCGTGGCCGGAGCT -> CGCTGTCGTGGCCGGAGCTG
TCGGCCGAACCGGATTCGGG -> CGGCCGAACCGGATTCGGGT
TCGGCGCCTCCAAGCTTAGG -> CGGCGCCTCCAAGCTTAGGG
TCGGGACCGTGTCGGGAGGG -> CGGGACCGTGTCGGGAGGGA
TCGGGAGGGACCAGTGTAAC -> CGGGAGGGACCAGTGTAACC
TCGGGTTCTAAGGTTCCTGT -> CGGGTTCTAAGGTTCCTGTT
TCGGTCGTCCCGGGTATGAG -> CGGTCGTCCCGGGTATGAGA
TCGTCCCGGGTATGAGAATT -> CGTCCCGGGTATGAGAATTT
TCGTCCTGGGGGCTCATACC -> CGTCCTGGGGGCTCATACCG
TCGTGATTCTACCCTGGCGC -> CGTGATTCTACCCTGGCGCT
TCGTGGCCGGAGCTGTCTAG -> CGTGGCCGGAGCTGTCTAGC
TCGTTAGCGCCTCCGACATG -> CGTTAGCGCCTCCGACATGC
TCGTTCAGTGATAACAGTGA -> CGTTCAGTGATAACAGTGAA
TCGTTTAAGTTTAGCTCCGA -> CGTTTAAGTTTAGCTCCGAC
TCGTTTTAACCATGTCTACT -> CGTTTTAACCATGTCTACTA
TCTAAGGTTCCTGTTCGTTT -> CTAAGGTTCCTGTTCGTTTT
TCTACCCTGGCGCTCCGCGA -> CTACCCTGGCGCTCCGCGAT
TCTACGTGGGGTGTCGGCCG -> CTACGTGGGGTGTCGGCCGA
TCTACTACTTCCTTCAAGGG -> CTACTACTTCCTTCAAGGGC
TCTAGCGAGAGCCCTAGGTG -> CTAGCGAGAGCCCTAGGTGA
TCTATAGTAACCTCGCCCGC -> CTATAGTAACCTCGCCCGCG
TCTATCGGCGCCTCCAAGCT -> CTATCGGCGCCTCCAAGCTT
TCTATTTCATGTAACAAAAA -> CTATTTCATGTAACAAAAAA
TCTCAGGTTATTTGCCCAAG -> CTCAGGTTATTTGCCCAAGG
TCTCATGCGTGCGATGCGGG -> CTCATGCGTGCGATGCGGGG
TCTCCGGGGCAGTCATACGG -> CTCCGGGGCAGTCATACGGT
TCTCTATCGGCGCCTCCAAG -> CTCTATCGGCGCCTCCAAGC
TCTGGGGAGTCCCTAGAGGC -> CTGGGGAGTCCCTAGAGGCG
TCTGGTGTCATGCAGTCATT -> CTGGTGTCATGCAGTCATTA
TCTGTAATGCCCAATTTACG -> CTGTAATGCCCAATTTACGC
TCTTACGTCGTTTAAGTTTA -> CTTACGTCGTTTAAGTTTAG
TCTTACTAAGTCACCGGATG -> CTTACTAAGTCACCGGATGG
TGAACATGACGCCGCGCAAG -> GAACATGACGCCGCGCAAGA
TGAATCCCGGAGCCCACCAT -> GAATCCCGGAGCCCACCATT
TGACATACATCAGGCCCCCT -> GACATACATCAGGCCCCCTG
TGACGCCGCGCAAGAAGGTA -> GACGCCGCGCAAGAAGGTAT
TGAGAATTTGCCGGGCTGCA -> GAGAATTTGCCGGGCTGCAT
TGAGTTAGCTTTTAGATCTC -> GAGTTAGCTTTTAGATCTCT
TGATAACAGTGAATCCCGGA -> GATAACAGTGAATCCCGGAG
TGATGTGCCCTAACTACTAC -> GATGTGCCCTAACTACTACC
TGATTCTACCCTGGCGCTCC -> GATTCTACCCTGGCGCTCCG
TGCACGGTGTGTCTTACGTC -> GCACGGTGTGTCTTACGTCG
TGCACTTTCTTACTAAGTCA -> GCACTTTCTTACTAAGTCAC
TGCAGTCATTAATCGCTGTC -> GCAGTCATTAATCGCTGTCG
TGCATCCCGATCAGAATTCA -> GCATCCCGATCAGAATTCAT
TGCATGAGTTAGCTTTTAGA -> GCATGAGTTAGCTTTTAGAT
TGCCCAAGGGCGCGCGAATT -> GCCCAAGGGCGCGCGAATTT
TGCCCAATTTACGCGCTCGG -> GCCCAATTTACGCGCTCGGG
TGCCCTAACTACTACCTGTG -> GCCCTAACTACTACCTGTGA
TGCCGACTTCCACTACTCCG -> GCCGACTTCCACTACTCCGT
TGCCGGGCTGCATCCCGATC -> GCCGGGCTGCATCCCGATCA
TGCCGGTAAGCATTGCACGG -> GCCGGTAAGCATTGCACGGT
TGCGACCAGTATACGAGTGC -> GCGACCAGTATACGAGTGCC
TGCGATGCGGGGATCTGGTG -> GCGATGCGGGGATCTGGTGT
TGCGGGGATCTGGTGTCATG -> GCGGGGATCTGGTGTCATGC
TGCGTGCGATGCGGGGATCT -> GCGTGCGATGCGGGGATCTG
TGCTATCGTGATTCTACCCT -> GCTATCGTGATTCTACCCTG
TGGACACGGTTTCACGTTTT -> GGACACGGTTTCACGTTTTC
TGGCATCTATAGTAACCTCG -> GGCATCTATAGTAACCTCGC
TGGCCGGAGCTGTCTAGCGA -> GGCCGGAGCTGTCTAGCGAG
TGGCGCTCCGCGATAACTAT -> GGCGCTCCGCGATAACTATC
TGGGGAGTCCCTAGAGGCGC -> GGGGAGTCCCTAGAGGCGCA
TGGGGGCTCATACCGGTAAA -> GGGGGCTCATACCGGTAAAC
TGGGGTGTCGGCCGAACCGG -> GGGGTGTCGGCCGAACCGGA
TGGTCCTGCATGAGTTAGCT -> GGTCCTGCATGAGTTAGCTT
TGGTCGTTCAGTGATAACAG -> GGTCGTTCAGTGATAACAGT
TGGTGGCATCTATAGTAACC -> GGTGGCATCTATAGTAACCT
TGGTGTCAGAAGGCAGCGTA -> GGTGTCAGAAGGCAGCGTAG
TGGTGTCATGCAGTCATTAA -> GGTGTCATGCAGTCATTAAT
TGTAACAAAAAATTGTGTAC -> GTAACAAAAAATTGTGTACA
TGTAACCGGCTGGTCCTGCA -> GTAACCGGCTGGTCCTGCAT
TGTAATGCCCAATTTACGCG -> GTAATGCCCAATTTACGCGC
TGTACATGTTGCGACCAGTA -> GTACATGTTGCGACCAGTAT
TGTCAGAAGGCAGCGTAGCG -> GTCAGAAGGCAGCGTAGCGG
TGTCATGCAGTCATTAATCG -> GTCATGCAGTCATTAATCGC
TGTCGGCCGAACCGGATTCG -> GTCGGCCGAACCGGATTCGG
TGTCGGGAGGGACCAGTGTA -> GTCGGGAGGGACCAGTGTAA
TGTCGTGGCCGGAGCTGTCT -> GTCGTGGCCGGAGCTGTCTA
TGTCTACTACTTCCTTCAAG -> GTCTACTACTTCCTTCAAGG
TGTCTAGCGAGAGCCCTAGG -> GTCTAGCGAGAGCCCTAGGT
TGTCTTACGTCGTTTAAGTT -> GTCTTACGTCGTTTAAGTTT
TGTGACATACATCAGGCCCC -> GTGACATACATCAGGCCCCC
TGTGATGTGCCCTAACTACT -> GTGATGTGCCCTAACTACTA
TGTGCCCTAACTACTACCTG -> GTGCCCTAACTACTACCTGT
TGTGTACATGTTGCGACCAG -> GTGTACATGTTGCGACCAGT
TGTGTCTTACGTCGTTTAAG -> GTGTCTTACGTCGTTTAAGT
TGTTCGTTTTAACCATGTCT -> GTTCGTTTTAACCATGTCTA
TGTTGCGACCAGTATACGAG -> GTTGCGACCAGTATACGAGT
TTAACCATGTCTACTACTTC -> TAACCATGTCTACTACTTCC
TTAAGTTTAGCTCCGACTAC -> TAAGTTTAGCTCCGACTACC
TTAATCGCTGTCGTGGCCGG -> TAATCGCTGTCGTGGCCGGA
TTACGCGCTCGGGACCGTGT -> TACGCGCTCGGGACCGTGTC
TTACGTCGTTTAAGTTTAGC -> TACGTCGTTTAAGTTTAGCT
TTACTAAGTCACCGGATGGT -> TACTAAGTCACCGGATGGTC
TTAGACCTACATAAACGTCC -> TAGACCTACATAAACGTCCG
TTAGATCTCTATCGGCGCCT -> TAGATCTCTATCGGCGCCTC
TTAGCGCCTCCGACATGCAC -> TAGCGCCTCCGACATGCACT
TTAGCTCCGACTACCGGCAC -> TAGCTCCGACTACCGGCACT
TTAGCTTTTAGATCTCTATC -> TAGCTTTTAGATCTCTATCG
TTAGGGTCGCTCGTCCTGGG -> TAGGGTCGCTCGTCCTGGGG
TTATTTGCCCAAGGGCGCGC -> TATTTGCCCAAGGGCGCGCG
TTCAAGGGCTCAAGACCCCA -> TCAAGGGCTCAAGACCCCAC
TTCACGTTTTCTCAGGTTAT -> TCACGTTTTCTCAGGTTATT
TTCAGTGATAACAGTGAATC -> TCAGTGATAACAGTGAATCC
TTCATGCCGGTAAGCATTGC -> TCATGCCGGTAAGCATTGCA
TTCATGTAACAAAAAATTGT -> TCATGTAACAAAAAATTGTG
TTCCACTACTCCGTCTCCGG -> TCCACTACTCCGTCTCCGGG
TTCCCATTCTGTAATGCCCA -> TCCCATTCTGTAATGCCCAA
TTCCTGTTCGTTTTAACCAT -> TCCTGTTCGTTTTAACCATG
TTCCTTCAAGGGCTCAAGAC -> TCCTTCAAGGGCTCAAGACC
TTCGAGGATCCGGCACAAGT -> TCGAGGATCCGGCACAAGTC
TTCGGGTTCTAAGGTTCCTG -> TCGGGTTCTAAGGTTCCTGT
TTCGTTTTAACCATGTCTAC -> TCGTTTTAACCATGTCTACT
TTCTAAGGTTCCTGTTCGTT -> TCTAAGGTTCCTGTTCGTTT
TTCTACCCTGGCGCTCCGCG -> TCTACCCTGGCGCTCCGCGA
TTCTCAGGTTATTTGCCCAA -> TCTCAGGTTATTTGCCCAAG
TTCTGTAATGCCCAATTTAC -> TCTGTAATGCCCAATTTACG
TTCTTACTAAGTCACCGGAT -> TCTTACTAAGTCACCGGATG
TTGCACGGTGTGTCTTACGT -> TGCACGGTGTGTCTTACGTC
TTGCCCAAGGGCGCGCGAAT -> TGCCCAAGGGCGCGCGAATT
TTGCCGGGCTGCATCCCGAT -> TGCCGGGCTGCATCCCGATC
TTGCGACCAGTATACGAGTG -> TGCGACCAGTATACGAGTGC
TTGGTGGCATCTATAGTAAC -> TGGTGGCATCTATAGTAACC
TTGTGTACATGTTGCGACCA -> TGTGTACATGTTGCGACCAG
TTTAACCATGTCTACTACTT -> TTAACCATGTCTACTACTTC
TTTAAGTTTAGCTCCGACTA -> TTAAGTTTAGCTCCGACTAC
TTTACGCGCTCGGGACCGTG -> TTACGCGCTCGGGACCGTGT
TTTAGATCTCTATCGGCGCC -> TTAGATCTCTATCGGCGCCT
TTTAGCTCCGACTACCGGCA -> TTAGCTCCGACTACCGGCAC
TTTCACGTTTTCTCAGGTTA -> TTCACGTTTTCTCAGGTTAT
TTTCATGTAACAAAAAATTG -> TTCATGTAACAAAAAATTGT
TTTCGAGGATCCGGCACAAG -> TTCGAGGATCCGGCACAAGT
TTTCTCAGGTTATTTGCCCA -> TTCTCAGGTTATTTGCCCAA
TTTCTTACTAAGTCACCGGA -> TTCTTACTAAGTCACCGGAT
TTTCTTCATTGAAACCGCGT -> TTCTTCATTGAAACCGCGTA
TTTGCCCAAGGGCGCGCGAA -> TTGCCCAAGGGCGCGCGAAT
TTTGCCGGGCTGCATCCCGA -> TTGCCGGGCTGCATCCCGAT
TTTGGTGGCATCTATAGTAA -> TTGGTGGCATCTATAGTAAC
TTTTAACCATGTCTACTACT -> TTTAACCATGTCTACTACTT
TTTTAGATCTCTATCGGCGC -> TTTAGATCTCTATCGGCGCC
TTTTCTCAGGTTATTTGCCC -> TTTCTCAGGTTATTTGCCCA
TTTTGGTGGCATCTATAGTA -> TTTGGTGGCATCTATAGTAA
